あ	逢
あ	会
あ	開
あ	空
あ	合
あ	在
あ	遭
あ	編
あ	飽
あ	明
あ	有
ああ	嗚呼
あい	愛
あい	藍
あいいれな	相容れな
あいおい	相生
あいか	哀歌
あいかぎ	合鍵
あいかた	相方
あいかわらず	相変わらず
あいかん	哀歓
あいがん	哀願
あいがん	愛玩
あいきょう	愛敬
あいきょう	愛嬌
あいくち	匕首
あいけん	愛犬
あいこ	愛顧
あいご	愛護
あいこう	愛好
あいこく	愛国
あいことな	相異な
あいさい	愛妻
あいさつ	挨拶
あいじ	愛児
あいしゅう	哀愁
あいしょう	愛唱
あいしょう	愛称
あいしょう	愛誦
あいしょう	相性
あいじょう	愛情
あいじん	愛人
あいす	アイス
あいず	合図
あいせき	哀惜
あいせつ	哀切
あいそ	愛想
あいぞう	愛憎
あいだ	間
あいたい	相対
あいだがら	間柄
あいちゃく	愛着
あいちょう	愛鳥
あいつ	相継
あいつ	相次
あいつう	相通
あいて	相手
あいてさき	相手先
あいとう	哀悼
あいどく	愛読
あいにく	生憎
あいびき	逢引
あいぶ	愛撫
あいべつ	哀別
あいま	合間
あいまい	曖昧
あいよう	愛用
あいらく	哀楽
あいらし	愛らし
あいろ	隘路
あうん	阿吽
あえ	和え
あえ	喘
あえて	敢えて
あえな	敢な
あえん	亜鉛
あお	仰
あお	青
あお	扇
あお	煽
あお	蒼
あお	碧
あおあお	青々
あおい	葵
あおおに	青鬼
あおがえる	青蛙
あおざめ	青ざめ
あおじろ	青白
あおぞら	青空
あおた	青田
あおば	青葉
あおむし	青虫
あおもの	青物
あおやぎ	青柳
あか	垢
あか	赤
あか	飽か
あか	明か
あが	挙が
あが	上が
あが	足掻
あが	騰が
あが	揚が
あかおに	赤鬼
あかがい	赤貝
あかげ	赤毛
あかげら	赤啄木鳥
あかご	赤子
あかし	証
あかし	灯
あかじ	赤字
あかしお	赤潮
あかせん	赤線
あかちん	赤チン
あかつき	暁
あかつち	赤土
あかっぱじ	赤っ恥
あかぬけ	垢抜け
あかね	茜
あかぼう	赤帽
あかまつ	赤松
あかまる	赤丸
あから	赤ら
あからがお	赤ら顔
あかり	灯
あかり	明かり
あかり	明り
あかる	明る
あかるみ	明るみ
あかんぼう	赤ん坊
あき	厭き
あき	秋
あき	飽き
あきさめ	秋雨
あきす	空巣
あきち	空き地
あきな	商
あきない	商い
あきばれ	秋晴れ
あきや	空き家
あきらか	明らか
あきらめ	諦め
あきれ	呆れ
あきれすけん	アキレス腱
あく	悪
あぐ	倦
あくい	悪意
あくえき	悪疫
あくじ	悪事
あくじき	悪食
あくしつ	悪疾
あくしつ	悪質
あくしゅ	悪手
あくしゅ	握手
あくしゅう	悪臭
あくしゅみ	悪趣味
あくせい	悪性
あくせん	悪戦
あくせん	悪銭
あくた	芥
あくたい	悪態
あくだま	悪玉
あくとく	悪徳
あくにん	悪人
あくば	悪罵
あくびょう	悪病
あくびょうどう	悪平等
あくへい	悪弊
あくへき	悪癖
あくま	悪魔
あくみょう	悪名
あくむ	悪夢
あくめい	悪名
あくやく	悪役
あくゆう	悪友
あくよう	悪用
あくりょう	悪霊
あくりょく	握力
あけ	開け
あけ	空け
あけ	朱
あけ	明け
あげ	挙げ
あげ	上げ
あげ	揚げ
あげあし	挙げ足
あげあし	挙足
あげあし	上げ足
あげあし	上足
あげあし	揚げ足
あげあし	揚足
あけがた	明け方
あげく	挙げ句
あげしお	上潮
あげぞこ	上げ底
あけっぴろげ	開けっ広げ
あげつら	論
あけはな	開け放
あけぼの	曙
あけわた	明け渡
あご	顎
あこがれ	憧れ
あさ	漁
あさ	浅
あさ	朝
あさ	麻
あざ	字
あさいち	朝市
あさがた	朝方
あさく	浅く
あさぐろ	浅黒
あさげ	朝餉
あざけ	嘲
あさせ	浅瀬
あさぢえ	浅知恵
あさって	明後日
あさっぱら	朝っぱら
あざな	糾
あさばん	朝晩
あさひ	旭
あさひ	朝日
あさまし	浅まし
あざむ	欺
あさめし	朝飯
あざやか	鮮やか
あさやけ	朝焼け
あさゆう	朝夕
あざらし	海豹
あさり	鯏
あし	悪し
あし	葦
あし	芦
あし	脚
あし	足
あじ	鯵
あじ	味
あじ	鰺
あしあと	足跡
あしおと	足音
あしがかり	足掛かり
あしがかり	足掛り
あしかけ	足掛け
あしがため	足固め
あしがる	足軽
あしきしゅうきゅう	ア式蹴球
あしくび	足首
あじけな	味気な
あしこし	足腰
あじさい	紫陽花
あししげく	足繁く
あしずり	足摺
あした	明日
あじつけ	味付け
あしどり	足取り
あしなみ	足並み
あしび	馬酔木
あじみ	味見
あしもと	足元
あしゅ	亜種
あじわ	味わ
あす	明日
あずか	与
あずか	預
あずか	預か
あずき	小豆
あずけ	預け
あずけいれ	預け入れ
あずさ	梓
あずま	東
あせ	汗
あせ	焦
あせ	褪せ
あぜ	畦
あぜ	畔
あせかき	汗かき
あぜくら	校倉
あぜんと	唖然と
あそ	遊
あそびごころ	遊び心
あそびまわ	遊び回
あた	当
あた	当た
あだ	仇
あだ	徒
あたい	価
あたい	値
あたえ	与え
あたたか	温か
あたたか	暖か
あたたま	温ま
あたたま	暖ま
あたため	温め
あたため	暖め
あだばな	徒花
あたま	頭
あたまうち	頭打ち
あたまかず	頭数
あたまきん	頭金
あたまごなし	頭ごなし
あたらし	新し
あたり	辺り
あたりまえ	当たりまえ
あたりまえ	当たり前
あたりまえ	当り前
あっ	圧
あつ	厚
あつ	暑
あつ	篤
あつ	熱
あつえん	圧延
あっか	悪化
あつか	扱
あつかいだか	扱い高
あつかまし	厚かまし
あつがみ	厚紙
あっかん	悪漢
あっかん	圧巻
あつかん	熱燗
あつぎ	厚着
あつくるし	暑苦し
あっけ	呆気
あつげしょう	厚化粧
あっけな	呆気な
あっこう	悪口
あつさ	暑さ
あっさく	圧搾
あっさつ	圧殺
あっし	圧死
あつじ	厚地
あっしゅく	圧縮
あっしょう	圧勝
あっせい	圧制
あっせん	斡旋
あつで	厚手
あっとう	圧倒
あっぱく	圧迫
あつま	集ま
あつめ	厚め
あつめ	集め
あつりょく	圧力
あつれき	軋轢
あて	宛
あて	宛て
あて	充て
あて	当て
あてさき	宛先
あてじ	宛て字
あてじ	宛字
あてじ	当て字
あてずっぽう	当てずっぽう
あてつけ	当てつけ
あてな	宛名
あてはま	当てはま
あてはめ	当てはめ
あと	後
あと	痕
あと	跡
あと	蹟
あとあと	後々
あとおし	後押し
あとがき	後書き
あとかたづけ	後かたづけ
あとがま	後釜
あとさき	後先
あとしまつ	後始末
あとだし	後出し
あとち	跡地
あとぢえ	後知恵
あとつぎ	跡継ぎ
あとばらい	後払い
あともどり	後戻り
あな	穴
あな	坑
あな	孔
あなうめ	穴埋め
あなた	貴方
あなたたち	あなた達
あなたたち	貴方達
あなど	侮
あに	兄
あにき	兄貴
あね	姐
あね	姉
あねったい	亜熱帯
あのよう	あの様
あば	暴
あばきだ	暴き出
あばらぼね	肋骨
あばれ	暴れ
あばれんぼう	暴れん坊
あび	浴び
あびきょうかん	阿鼻叫喚
あびせ	浴びせ
あひる	アヒル
あひる	家鴨
あぶ	虻
あぶな	危な
あぶなっかし	危なっかし
あぶみ	鐙
あぶら	脂
あぶら	油
あぶらえ	油絵
あぶらぎ	脂ぎ
あぶらしょう	脂性
あぶらっこ	油っこ
あふれ	溢れ
あへん	阿片
あほう	阿呆
あほうどり	信天翁
あま	海女
あま	甘
あま	剰
あま	尼
あま	余
あまあし	雨足
あまえ	甘え
あまがえる	雨蛙
あまがき	甘柿
あまがさ	雨がさ
あまがさ	雨ガサ
あまがさ	雨傘
あまから	甘辛
あまくだり	天下り
あまくち	甘口
あまぐも	雨雲
あまごい	雨乞い
あまた	数多
あまだれ	雨だれ
あまったる	甘ったる
あまでら	尼寺
あまど	雨戸
あまのじゃく	天の邪鬼
あまのじゃく	天邪鬼
あまみ	甘味
あまみず	雨水
あまもり	雨漏り
あまやか	甘やか
あまん	甘ん
あみ	網
あみかけ	網かけ
あみき	編み機
あみだな	網棚
あみめ	編目
あみめ	網目
あめ	飴
あめ	雨
あめあがり	雨上がり
あめふり	雨ふり
あめふり	雨降り
あや	絢
あや	綾
あや	彩
あや	彪
あや	文
あやう	危う
あやぎぬ	綺
あやし	怪し
あやし	妖し
あやつ	操
あやぶ	危ぶ
あやま	過
あやま	誤
あやま	謝
あやめ	殺め
あやめ	菖蒲
あゆ	阿諛
あゆ	鮎
あゆ	歩
あゆみよ	歩み寄
あら	荒
あら	荒ら
あら	洗
あら	粗
あらあらし	荒々し
あらいおと	洗い落と
あらいざらい	洗いざらい
あらいそ	荒磯
あらいだ	洗い出
あらいなが	洗い流
あらが	抗
あらかじめ	予め
あらかた	粗方
あらぎょう	荒行
あらくれ	荒くれ
あらげ	荒げ
あらけずり	荒削り
あらごなし	荒ごなし
あらし	嵐
あらしまわ	荒し回
あらすじ	粗筋
あらそ	争
あらた	新た
あらたか	灼か
あらたま	改ま
あらため	改め
あらためて	改めて
あらっぽ	荒っぽ
あらて	新手
あらと	荒砥
あらなみ	荒波
あらなわ	荒縄
あらまき	新巻
あらりょうじ	荒療治
あらわ	現
あらわ	著
あらわ	表
あらわ	露わ
あらわれ	現れ
あらわれ	現われ
あらわれ	表れ
あり	蟻
あり	有り
ありあわせ	有り合わせ
ありか	在処
ありがた	有難
ありがたみ	ありがた味
ありがたみ	有難味
ありがとう	有難う
ありがね	有り金
ありさま	有り様
ありったけ	有りったけ
ありてい	有り体
ありとあらゆる	有りとあらゆる
ありとある	有りとある
ありゅう	亜流
ありゅうさん	亜硫酸
ある	或
ある	歩
あるいは	或は
あるがまま	有るがまま
あるじ	主
あるちゅう	アル中
あれ	荒れ
あれ	粗れ
あわ	粟
あわ	会わ
あわ	合わ
あわ	淡
あわ	泡
あわさ	合わさ
あわせ	袷
あわせ	合わせ
あわせ	併せ
あわせて	併せて
あわだ	泡立
あわて	慌て
あわび	鮑
あわゆき	淡雪
あわれ	哀れ
あわれ	憐れ
あん	按
あん	案
あん	餡
あんい	安易
あんいつ	安逸
あんうん	暗雲
あんか	安価
あんがい	案外
あんかん	安閑
あんき	暗記
あんき	暗鬼
あんきょ	安居
あんけん	案件
あんこ	アンコ
あんこう	鮟鱇
あんごう	暗号
あんこがた	アンコ形
あんこく	暗黒
あんさつ	暗殺
あんざん	暗算
あんし	暗視
あんじ	暗示
あんじ	案じ
あんしつ	暗室
あんじゅう	安住
あんしゅつ	案出
あんしょ	暗所
あんしょう	暗唱
あんしょう	暗礁
あんしょう	暗証
あんしょう	暗誦
あんしょく	暗色
あんしん	安心
あんず	杏
あんせい	安静
あんぜん	安全
あんそく	安息
あんたい	安泰
あんたん	暗澹
あんち	安置
あんちゅう	暗中
あんちゅうもさく	暗中模索
あんちょく	安直
あんてい	安定
あんてな	アンテナ
あんど	安堵
あんない	案内
あんに	暗に
あんのじょう	案の定
あんばい	塩梅
あんぴ	安否
あんぷ	暗譜
あんぶん	按分
あんぽ	安保
あんま	按摩
あんみん	安眠
あんもく	暗黙
あんやく	暗躍
あんゆ	暗喩
あんらく	安楽
い	意
い	異
い	胃
い	衣
い	謂
い	医
い	井
い	亥
い	云
い	往
い	忌
い	居
い	言
い	射
い	煎
い	鋳
い	入
い	要
い	良
いあつ	威圧
いあん	慰安
いいあ	言い合
いいあらそ	言い争
いいあらわ	言い表
いいかえ	言い換え
いいかえ	言い替え
いいかえ	言い返
いいかげん	いい加減
いいかね	言い兼ね
いいかわ	言い交わ
いいき	言い切
いいくるめ	言いくるめ
いいすて	言い捨て
いいそこな	言い損な
いいだ	言い出
いいだくだく	唯々諾々
いいだしっぺ	言い出しっぺ
いいつけ	言いつけ
いいなお	言い直
いいなずけ	許嫁
いいのがれ	言い逃れ
いいは	言い張
いいふくめ	言い含め
いいふら	言い触ら
いいぶん	言い分
いいまわし	言い回し
いいわけ	言い訳
いいわた	言い渡
いいん	委員
いいん	医院
いいんかい	委員会
いえ	家
いえ	癒え
いえがら	家柄
いえじ	家路
いえで	家出
いえもと	家元
いえん	胃炎
いおう	硫黄
いおり	庵
いか	以下
いか	異化
いか	医科
いか	烏賊
いか	活か
いか	生か
いか	怒
いか	如何
いがい	以外
いがい	意外
いがい	遺骸
いかいよう	胃潰瘍
いかが	如何
いかく	威嚇
いがく	医学
いがくぶ	医学部
いかすい	胃下垂
いかだ	筏
いがた	鋳型
いかどうぶん	以下同文
いかなる	如何なる
いがみあ	いがみ合
いかり	碇
いかり	錨
いかん	尉官
いかん	移管
いかん	衣冠
いかん	遺憾
いかん	如何
いがん	依願
いがん	胃癌
いき	意気
いき	遺棄
いき	域
いき	活き
いき	粋
いき	生き
いき	息
いぎ	意義
いぎ	異義
いぎ	異議
いきいき	生き生き
いきうめ	生き埋め
いきおい	勢い
いきおいこ	勢い込
いきおいづ	勢い付
いきか	閾下
いきがい	生きがい
いきかえ	生き返
いきき	行き来
いきぎれ	息切れ
いきぐるし	息苦し
いきご	意気込
いきさき	行き先
いきさつ	経緯
いきすぎ	行き過ぎ
いきち	生き血
いきち	閾値
いきちが	行き違
いきづま	息詰ま
いきどお	憤
いきとしいける	生きとし生ける
いきとど	行き届
いきぬき	息抜き
いきのこ	生き残
いきもの	生き物
いきょ	依拠
いきょう	異境
いきょう	異郷
いぎょう	偉業
いぎょう	遺業
いぎょう	医業
いきょうと	異教徒
いきょく	委曲
いきょく	医局
いきりょう	生霊
いきわた	行き渡
いくえ	幾重
いくえい	育英
いくさ	戦
いくじ	育児
いくしゅ	育種
いくせい	育成
いくた	幾多
いくつ	幾つ
いくど	幾度
いくどうおん	異口同音
いくにち	幾日
いくぶん	幾分
いくら	幾ら
いくらか	幾らか
いけ	生け
いけ	池
いけい	畏敬
いけがき	生け垣
いげた	井桁
いけど	生け捕
いけばな	生け花
いけん	意見
いけん	異見
いけん	違憲
いげん	威厳
いご	以後
いご	囲碁
いこい	憩
いこい	憩い
いこう	以降
いこう	意向
いこう	移行
いこう	移項
いこく	異国
いごこち	居心地
いこじ	依怙地
いこじ	意固地
いこつ	遺骨
いこん	遺恨
いごん	遺言
いさ	勇
いさい	委細
いさい	異彩
いさか	諍
いさかい	諍い
いざかや	居酒屋
いさぎよ	潔
いさく	遺作
いざな	誘
いさまし	勇まし
いさみ	勇
いさみあし	勇み足
いさむ	勇
いさめ	諌め
いさん	遺産
いし	意志
いし	意思
いし	遺志
いし	医師
いし	石
いじ	意地
いじ	維持
いじ	遺児
いしがき	石垣
いしき	意識
いしずえ	礎
いしつ	異質
いしつ	遺失
いしばし	石橋
いしぶみ	碑
いじめ	苛め
いしゃ	慰謝
いしゃ	医者
いしゅ	意趣
いしゅ	異種
いしゅう	異臭
いしゅう	蝟集
いじゅう	移住
いしゅく	萎縮
いしゅつ	移出
いしゆみ	弩
いしょ	遺書
いしょ	医書
いしょう	意匠
いしょう	衣装
いじょう	以上
いじょう	委譲
いじょう	異常
いじょう	異状
いじょう	移譲
いしょく	委嘱
いしょく	異色
いしょく	移植
いしょく	衣食
いしょくじゅう	衣食住
いじわる	意地悪
いしん	威信
いしん	維新
いじん	偉人
いじん	異人
いしんでんしん	以心伝心
いす	椅子
いずみ	泉
いすわ	居座
いせい	威勢
いせい	異性
いせい	異星
いせいしゃ	為政者
いせき	移籍
いせき	遺跡
いせつ	異説
いせつ	移設
いぜん	以前
いぜん	依然
いぜん	已然
いぜんけい	已然形
いそ	磯
いそ	急
いそう	位相
いそう	移送
いぞう	遺贈
いそうろう	居候
いそがし	忙し
いぞく	遺族
いそし	勤し
いそじ	五十路
いそん	依存
いぞん	依存
いぞん	異存
いた	至
いた	傷
いた	致
いた	痛
いた	悼
いた	到
いた	板
いだ	抱
いたい	異体
いたい	遺体
いだい	偉大
いだい	医大
いたいじ	異体字
いたいたし	痛々し
いたく	依託
いたく	委託
いたけだか	居丈高
いたしかたな	致し方な
いたずら	悪戯
いたずら	徒
いたずらに	徒に
いただ	戴
いただき	頂
いたたまらな	居たたまらな
いたたまらな	居た堪らな
いたたまれな	居たたまれな
いたで	痛手
いたば	板場
いたまえ	板前
いたまし	痛まし
いため	傷め
いため	痛め
いため	炒め
いためつけ	痛めつけ
いたれりつくせり	至れり尽くせり
いたん	異端
いち	位置
いち	一
いち	壱
いち	市
いちい	一意
いちいち	一々
いちいてき	一意的
いちいん	一員
いちいん	一因
いちえん	一円
いちおう	一応
いちがいに	一概に
いちかごん	一家言
いちがん	一丸
いちがん	一眼
いちげき	一撃
いちげん	一見
いちげん	一元
いちげん	一言
いちご	苺
いちごん	一言
いちじ	一事
いちじ	一字
いちじ	一時
いちじ	一次
いちじゅういっさい	一汁一菜
いちじょ	一助
いちじるし	著し
いちぞん	一存
いちたいた	一対多
いちだん	一団
いちだん	一段
いちだんらく	一段落
いちづけ	位置づけ
いちづけ	位置付け
いちど	一度
いちどう	一同
いちどう	一堂
いちどき	一時
いちどく	一読
いちにん	一任
いちにんしょう	一人称
いちにんまえ	一人前
いちねん	一年
いちねん	一念
いちば	市場
いちはや	逸早
いちはやく	いち早く
いちばん	一番
いちぶ	一部
いちぶぶん	一部分
いちぶん	一文
いちぼう	一望
いちまつ	一抹
いちまつ	市松
いちめい	一命
いちめん	一面
いちもく	一目
いちもくりょうぜん	一目瞭然
いちもん	一門
いちや	一夜
いちやく	一躍
いちゅう	意中
いちょ	遺著
いちょう	胃腸
いちょう	銀杏
いちよう	一様
いちらん	一覧
いちり	一理
いちりつ	一律
いちりつ	市立
いちりづか	一里塚
いちりゅう	一流
いちる	一縷
いちれい	一例
いちれん	一連
いちろ	一路
いっ	逸
いつ	何時
いつう	胃痛
いっか	一下
いっか	一家
いつか	5日
いつか	５日
いつか	五日
いっかい	一介
いっかい	一回
いっかく	一角
いっかせい	一過性
いっかつ	一喝
いっかつ	一括
いっかん	一巻
いっかん	一環
いっかん	一貫
いっき	一期
いっき	一揆
いっきとうせん	一騎当千
いっきに	一気に
いっきょ	一挙
いっきょう	一興
いつくし	慈し
いっけい	一計
いっけん	一見
いっけん	一軒
いっけんらくちゃく	一件落着
いっこう	一向
いっこう	一行
いっこく	一刻
いっこく	一国
いっさい	一切
いつざい	逸材
いっさいがっさい	一切合財
いっさいたふ	一妻多夫
いっさくじつ	一昨日
いっさくねん	一昨年
いっさんかたんそ	一酸化炭素
いっしき	一式
いっしつ	一失
いっしつ	一室
いっしゅ	一種
いっしゅ	一首
いっしゅう	一周
いっしゅう	一蹴
いっしゅうかん	一週間
いっしゅん	一瞬
いっしょ	一緒
いっしょう	一章
いっしょう	一生
いっしょうけんめい	一生懸命
いっしょくそくはつ	一触即発
いっしょくた	一緒くた
いっしょけんめい	一所懸命
いっしん	一審
いっしん	一心
いっしん	一新
いっしん	一身
いっしんどうたい	一心同体
いっしんに	一心に
いっしんふらん	一心不乱
いっすい	一睡
いっせい	一世
いっせい	一斉
いっせいに	一斉に
いっせきにちょう	一石二鳥
いっせつ	一説
いっせん	一千
いっせん	一線
いっそう	一層
いっそう	一掃
いっそく	一足
いったい	一体
いったい	一帯
いつだつ	逸脱
いったん	一たん
いったん	一旦
いったん	一端
いっち	一致
いっちゅうや	一昼夜
いっちょういっせき	一朝一夕
いっちょういったん	一長一短
いっちょうら	一張羅
いつつ	五つ
いって	一手
いってい	一定
いってん	一転
いってん	一点
いっと	一途
いっとう	一等
いっとう	一頭
いっとき	一時
いっぱ	一派
いっぱい	一杯
いっぱく	一泊
いっぱつ	一発
いっぱん	一般
いっぱんか	一般化
いっぱんてき	一般的
いっぴつ	一筆
いっぴん	逸品
いつぶ	鋳潰
いっぷう	一風
いっぷく	一服
いっぷたさい	一夫多妻
いっぺん	一変
いっぺん	一辺
いっぺんとう	一辺倒
いっぽ	一歩
いっぽう	一報
いっぽう	一方
いっぽん	一本
いつわ	逸話
いつわ	偽
いて	射手
いてき	夷狄
いてつ	凍てつ
いてん	移転
いでん	遺伝
いでんし	遺伝子
いと	意図
いと	厭
いと	糸
いど	緯度
いど	井戸
いど	挑
いどう	異動
いどう	異同
いどう	移動
いとぐち	糸口
いどころ	居所
いとし	愛し
いどし	亥年
いとしの	愛しの
いとぞこ	糸底
いとな	営
いどばた	井戸端
いとま	暇
いとめ	射止め
いな	否
いない	以内
いなお	居直
いなか	田舎
いなかっぺ	田舎っぺ
いなずま	稲妻
いなびかり	稲光
いなら	居並
いなり	稲荷
いにゅう	移入
いにん	委任
いぬ	狗
いぬ	犬
いぬ	射貫
いぬ	戌
いぬい	乾
いぬかき	犬かき
いぬき	居抜き
いぬころ	犬ころ
いぬっころ	犬っころ
いぬどし	戊年
いね	稲
いね	禾
いねかり	稲刈り
いねむり	居眠り
いの	祈
いの	祷
いのこ	居残
いのしし	猪
いのち	命
いのちごい	命乞い
いのちづな	命綱
いば	威張
いはい	違背
いはく	曰く
いばしょ	居場所
いばら	茨
いはん	違反
いひょう	意表
いひん	遺品
いふ	畏怖
いふう	威風
いぶき	息吹
いふく	衣服
いぶつ	異物
いぶつ	遺物
いへん	異変
いほう	異邦
いほう	違法
いま	居間
いま	今
いまいまし	忌々し
いまごろ	今ごろ
いまさら	今さら
いまさら	今更
いましがた	今しがた
いましめ	戒め
いまだ	未だ
いままで	今まで
いまわし	忌まわし
いみ	意味
いみん	移民
いむ	医務
いめい	異名
いも	芋
いもうと	妹
いもの	鋳物
いもむし	芋虫
いもん	慰問
いや	厭
いや	嫌
いや	癒
いやおう	否応
いやおうなしに	否応なしに
いやがおうでも	いやが応でも
いやく	意訳
いやく	違約
いやく	医薬
いやくきん	違約金
いやけ	嫌気
いやし	賎し
いやし	卑し
いやしめ	卑しめ
いやま	いや増
いやみ	厭味
いやみ	嫌味
いやみったらし	厭味ったらし
いゆう	畏友
いよう	威容
いよう	異様
いよく	意欲
いらい	以来
いらい	依頼
いらいら	苛々
いらか	甍
いらだ	苛立
いりえ	入り江
いりえ	入江
いりく	入り組
いりぐち	入口
いりこ	入り込
いりゅう	慰留
いりゅう	遺留
いりょう	衣料
いりょう	医療
いりょく	威力
いるい	衣類
いるか	海豚
いれ	入れ
いれ	容れ
いれい	慰霊
いれい	異例
いれかえ	入れ換え
いれかえ	入れ替え
いれかわ	入れ替わ
いれこ	入れ込
いれこ	入れ子
いれぢえ	入れ知恵
いれなお	入れ直
いろ	色
いろあい	色合い
いろあせ	色あせ
いろあせ	色褪せ
いろいろ	色色
いろいろ	色々
いろう	慰労
いろう	遺漏
いろけ	色気
いろこ	色子
いろずり	色刷
いろづ	色づ
いろっぽ	色っぽ
いろど	彩
いろめ	色め
いろめ	色目
いろわけ	色分け
いろん	異論
いろんな	色んな
いわ	岩
いわ	祝
いわ	磐
いわお	巌
いわかど	岩角
いわかん	違和感
いわく	曰く
いわし	鰯
いわし	鰮
いわば	謂わば
いわば	岩場
いわば	言わば
いわはだ	岩肌
いん	印
いん	因
いん	飲
いん	陰
いん	韻
いんいおん	陰イオン
いんえい	陰影
いんか	印加
いんか	引火
いんが	因果
いんが	陰画
いんがい	員外
いんがい	院外
いんがし	印画紙
いんかん	印鑑
いんき	陰気
いんきょ	隠居
いんきょく	陰極
いんきん	陰金
いんぎん	慇懃
いんけん	陰険
いんこう	咽喉
いんこう	淫行
いんごう	因業
いんこく	印刻
いんさつ	印刷
いんさん	陰惨
いんし	印紙
いんし	因子
いんし	院試
いんじ	印字
いんじ	印璽
いんしつ	陰湿
いんしゅ	飲酒
いんしゅう	因習
いんしょう	印章
いんしょう	印象
いんしょうづけ	印象づけ
いんしょうづけ	印象付け
いんしょく	飲食
いんすう	員数
いんすう	因数
いんせい	院政
いんせい	院生
いんせい	陰性
いんせい	隠棲
いんぜい	印税
いんせき	姻戚
いんせき	引責
いんせき	隕石
いんぜみ	院ゼミ
いんぞく	姻族
いんそつ	引率
いんたい	引退
いんちょう	院長
いんとう	淫蕩
いんどう	引導
いんとく	隠匿
いんねん	因縁
いんばい	淫売
いんび	淫靡
いんぼう	陰謀
いんゆ	隠喩
いんよう	引用
いんよう	飲用
いんよう	陰陽
いんりょう	飲料
いんりょうすい	飲料水
いんりょく	引力
いんれき	陰暦
いんろう	印籠
う	鵜
う	撃
う	産
う	生
う	打
う	討
う	得
う	膿
う	売
う	伐
う	浮
う	憂
うい	有為
ういういし	初々し
ういざん	初産
うーろんちゃ	烏龍茶
うえ	飢え
うえ	上
うえ	植え
うぇい	ウェイ
うえき	植木
うえこ	植え込
うえした	上下
うえじに	餓死
うえつけ	植え付け
うえは	ウエハ
うえん	迂遠
うお	魚
うおうさおう	右往左往
うか	羽化
うか	受か
うか	浮か
うかい	迂回
うかい	鵜飼い
うかが	窺
うかが	伺
うかつ	迂闊
うかべ	浮かべ
うかれ	浮かれ
うがん	右岸
うき	右記
うき	雨期
うき	雨季
うきくさ	浮草
うきしずみ	浮き沈み
うきな	浮名
うきぶくろ	浮袋
うきぼり	浮き彫り
うきよえ	浮世絵
うぐいす	鴬
うけ	受け
うけ	承け
うけ	請け
うけあ	請け合
うけい	右傾
うけいれ	受け入れ
うけうり	受け売り
うけお	請け負
うけおい	請負
うけこたえ	受け答え
うけざら	受け皿
うけしょ	請書
うけたまわ	承
うけつ	受け継
うけつけ	受け付け
うけつけ	受付
うけて	受け手
うけと	受け取
うけとめ	受け止め
うけとり	受取
うけなが	受け流
うけにん	請人
うけはらい	受払い
うけみ	受身
うけも	受け持
うけわたし	受渡し
うげん	右舷
うご	動
うごか	動か
うごきだ	動き出
うごめ	蠕
うこん	鬱金
うさぎ	兎
うさぎ	菟
うし	丑
うし	牛
うし	齲歯
うじ	氏
うしお	潮
うしがえる	牛蛙
うじがみ	氏神
うしどし	丑年
うしな	失
うしな	喪
うしみつ	丑三つ
うしみつどき	丑三つ刻
うじむし	蛆虫
うじょう	有情
うしろ	後ろ
うしろあし	後ろ足
うしろすがた	後ろ姿
うしろだて	後ろだて
うしろむき	後向き
うしろめた	後ろめた
うす	碓
うす	臼
うす	薄
うず	渦
うすい	雨水
うすうす	薄々
うすがた	薄型
うすぎ	薄着
うすぎり	薄切り
うすくち	薄口
うずくま	蹲
うすぐら	薄暗
うすげしょう	薄化粧
うすじ	薄地
うすじお	薄塩
うすちゃ	薄茶
うすで	薄手
うすび	薄日
うすま	薄ま
うずま	渦巻
うずま	埋ま
うずまき	渦巻
うすまく	薄膜
うすめ	薄め
うずめ	埋め
うずもれ	埋もれ
うすら	薄ら
うすれ	薄れ
うせ	失せ
うせい	迂生
うせつ	右折
うそ	ウソ
うそ	嘘
うぞうむぞう	有象無象
うそく	右側
うそっぱち	嘘っ八
うた	唄
うた	詠
うた	歌
うた	詩
うた	唱
うたい	謡
うたが	疑
うたがわし	疑わし
うたぐ	疑
うたぐりぶか	疑り深
うたげ	宴
うたごえ	歌声
うたたね	うたた寝
うたん	右端
うち	家
うち	中
うち	内
うち	裡
うちあ	撃ち合
うちあけ	打ち明け
うちあげ	打ち上げ
うちあけばなし	打ち明け話
うちあわせ	打ち合せ
うちあわせ	打合せ
うちいわい	内祝
うちうち	内々
うちおと	撃ち落と
うちか	打ち勝
うちかけ	打掛け
うちがわ	内側
うちき	打ち切
うちき	内気
うちきず	打傷
うちきん	内金
うちくだ	打ち砕
うちけ	打ち消
うちこ	打ち込
うちすて	打ち捨て
うちだ	打ち出
うちでし	内弟子
うちとけ	打ち解け
うちひし	打ちひし
うちべんけい	内弁慶
うちぼり	内堀
うちまく	内幕
うちみ	打ち身
うちみず	打ち水
うちやぶ	打ち破
うちゅう	宇宙
うちょうてん	有頂天
うちわ	内輪
うちわけ	内訳
うつ	移
うつ	欝
うつ	映
うつ	写
うづき	卯月
うつくし	美し
うっくつ	鬱屈
うつしだ	映し出
うつしと	写し取
うっせき	うっ積
うっせき	鬱積
うったえ	訴え
うっど	ウッド
うつびょう	鬱病
うつぼ	靭
うつむ	俯
うつりぎ	移り気
うつろ	移ろ
うつろ	虚ろ
うつわ	器
うで	腕
うでぎ	腕木
うできき	腕利き
うでどけい	腕時計
うでまえ	腕前
うでわ	腕輪
うてん	雨天
うと	疎
うどし	卯年
うとまし	疎まし
うとん	疎ん
うどん	饂飩
うどんこ	うどん粉
うどんこ	饂飩粉
うなが	促
うなぎ	鰻
うなじ	項
うなず	頷
うなどん	うな丼
うなばら	海原
うぬぼれ	自惚れ
うね	畦
うね	畝
うのみ	鵜呑み
うは	右派
うば	姥
うば	奪
うば	乳母
うばいと	奪い取
うぶ	産
うぶ	初
うぶぎ	産着
うぶげ	産毛
うぶごえ	産声
うぶすな	産土
うぶゆ	産湯
うへん	右辺
うま	午
うま	旨
うま	馬
うま	埋ま
うまづら	馬面
うまどし	午年
うまに	甘煮
うまぬし	馬主
うまみ	旨味
うまや	厩
うまれ	産まれ
うまれ	生まれ
うまれかわ	生まれ変わ
うまれつき	生まれつき
うみ	海
うみ	膿
うみおと	産み落と
うみせんやません	海千山千
うみぞい	海沿い
うみだ	生み出
うみどり	海鳥
うみべ	海辺
うむ	有無
うめ	梅
うめ	埋め
うめ	呻
うめあわせ	埋め合せ
うめあわせ	埋め合わせ
うめこ	埋め込
うめしゅ	梅酒
うめたて	埋め立て
うめたて	埋立
うめたてち	埋立地
うめぼし	梅干
うめぼし	梅干し
うめみ	梅見
うもう	羽毛
うもれ	埋もれ
うやうやし	恭し
うやま	敬
うよ	紆余
うよく	右翼
うら	浦
うら	怨
うら	恨
うら	裏
うら	裡
うらおもて	裏表
うらがえ	裏返
うらがき	裏書
うらかた	裏方
うらがなし	うら悲し
うらがね	裏金
うらがわ	裏側
うらぎ	裏切
うらぐち	裏口
うらさく	裏作
うらさびし	うら寂し
うらじ	裏地
うらづけ	裏付け
うらて	裏手
うらな	占
うらない	卦
うらにわ	裏庭
うらはら	裏腹
うらまち	裏町
うらみち	裏道
うらめ	裏目
うらめし	恨めし
うらや	羨
うらやま	裏山
うらやまし	羨まし
うららか	麗らか
うらん	ウラン
うり	瓜
うりあげ	売り上げ
うりあげ	売上
うりあげきん	売上金
うりあげだか	売上高
うりかい	売り買い
うりかけ	売り掛け
うりかけきん	売掛金
うりきれ	売り切れ
うりこ	売り込
うりこ	売子
うりだ	売り出
うりだし	売出
うりて	売り手
うりぬけ	売り抜け
うりぬし	売り主
うりね	売値
うりば	売場
うりはら	売り払
うりょう	雨量
うりわた	売り渡
うるう	閏
うるうどし	閏年
うるお	潤
うるさ	五月蝿
うるさ	煩
うるし	漆
うるち	粳
うるちまい	粳米
うるわし	麗し
うるわしの	麗しの
うれ	熟れ
うれい	愁い
うれい	憂い
うれえ	愁え
うれえ	憂え
うれくち	売れ口
うれし	嬉し
うれっこ	売れっ子
うれのこ	売れ残
うれゆき	売行き
うろ	迂路
うろおぼえ	うろ覚え
うろこ	鱗
うろん	胡乱
うわがき	上書き
うわがわ	上側
うわき	浮気
うわぎ	上着
うわぐすり	釉
うわぐつ	上靴
うわさ	噂
うわすべり	上滑り
うわづみ	上積み
うわぬり	上塗り
うわのせ	上乗せ
うわばき	上履き
うわべ	上辺
うわまえ	上前
うわまわ	上回
うわむ	上向
うわむき	上向き
うわめ	上目
うわやく	上役
うん	云
うん	運
うん	雲
うんえい	運営
うんが	運河
うんかい	雲海
うんきゅう	運休
うんこう	運航
うんこう	運行
うんさん	雲散
うんざん	運算
うんしん	運針
うんせい	運勢
うんそう	運送
うんそうや	運送屋
うんちく	蘊蓄
うんちん	運賃
うんでい	雲泥
うんてん	運転
うんてんしゅ	運転手
うんどう	運動
うんどうかい	運動会
うんどうじょう	運動場
うんどうりょう	運動量
うんどんこん	運鈍根
うんぬん	云々
うんぱん	運搬
うんぴつ	運筆
うんめい	運命
うんゆ	運輸
うんよう	運用
うんりょう	雲量
え	餌
え	画
え	絵
え	獲
え	笑
え	選
え	得
え	柄
えい	映
えい	栄
えい	詠
えいい	鋭意
えいえん	永遠
えいが	映画
えいが	栄華
えいがかん	映画館
えいかく	鋭角
えいかん	栄冠
えいき	鋭気
えいきゅう	永久
えいきゅうし	永久歯
えいきょう	影響
えいぎょう	営業
えいぎょうか	営業課
えいぎょうちゅう	営業中
えいぎょうぶ	営業部
えいこう	曳光
えいこう	曳航
えいこう	栄光
えいごう	永劫
えいこせいすい	栄枯盛衰
えいさい	英才
えいじ	嬰児
えいじ	映じ
えいじ	英字
えいしゃ	映写
えいしゃき	映写機
えいじゅう	永住
えいしん	栄進
えいせい	永世
えいせい	永逝
えいせい	衛星
えいせい	衛生
えいせいし	衛生士
えいぜん	営繕
えいぞう	営造
えいぞう	映像
えいぞく	永続
えいたつ	栄達
えいたん	詠嘆
えいだん	営団
えいだん	英断
えいち	叡智
えいち	英知
えいてん	栄転
えいねん	永年
えいびん	鋭敏
えいぶん	英文
えいみん	永眠
えいめい	英明
えいやく	英訳
えいゆう	英雄
えいよう	栄養
えいようか	栄養価
えいようし	栄養士
えいようそ	栄養素
えいり	営利
えいり	鋭利
えいりん	営林
えいりん	映倫
えいりんしょ	営林署
えいわ	英和
えが	描
えがお	笑顔
えがら	絵柄
えき	易
えき	液
えき	益
えき	駅
えき	役
えきいん	駅員
えきか	液化
えきがく	疫学
えきしゃ	易者
えきしょう	液晶
えきじょう	液状
えきせい	液性
えきたい	液体
えきちょう	駅長
えきでん	駅伝
えきびょう	疫病
えきまえ	駅前
えきまえどおり	駅前通り
えきむ	役務
えきめい	駅名
えきり	疫痢
えさ	餌
えし	絵師
えじき	餌食
えしゃく	会釈
えだ	枝
えたい	得体
えだは	枝葉
えだぶり	枝振り
えだまめ	枝豆
えだみち	枝道
えっきょう	越境
えづけ	餌付け
えっけん	謁見
えっけん	越権
えっとう	越冬
えつねん	越年
えつらく	悦楽
えつらん	閲覧
えて	得手
えてして	得てして
えと	干支
えとく	会得
えどま	江戸間
えにし	縁
えのき	榎
えのぐ	絵の具
えはがき	絵はがき
えばら	荏原
えび	蝦
えび	海老
えび	鰕
えびす	夷
えびす	恵比寿
えびす	恵比須
えびす	胡
えびちゃ	葡萄茶
えふだ	絵札
えぼし	烏帽子
えほん	絵本
えま	絵馬
えまき	絵巻
えもの	獲物
えら	偉
えら	撰
えら	選
えら	鰓
えらびだ	選び出
えらぶ	偉ぶ
えり	衿
えり	襟
えりくび	襟首
えりぬ	えり抜
えりぬき	選り抜き
えりもと	襟元
えん	円
えん	園
えん	宴
えん	演
えん	縁
えん	苑
えん	塩
えんえい	遠泳
えんえき	演繹
えんえん	延々
えんか	演歌
えんか	塩化
えんかい	宴会
えんかい	沿海
えんかい	遠海
えんかく	沿革
えんかく	遠隔
えんかくち	遠隔地
えんかつ	円滑
えんがわ	縁側
えんかん	円環
えんがん	沿岸
えんき	延期
えんぎ	演技
えんぎ	縁起
えんきょり	遠距離
えんきん	遠近
えんけい	円形
えんけい	遠景
えんげい	園芸
えんげい	演芸
えんげき	演劇
えんこ	円弧
えんこ	縁故
えんご	掩護
えんご	援護
えんこん	怨恨
えんさ	怨嗟
えんさん	塩酸
えんざん	演算
えんし	遠視
えんじ	園児
えんじ	演じ
えんじゃ	縁者
えんじゃく	燕雀
えんしゅう	円周
えんしゅう	演習
えんじゅく	円熟
えんじゅくみ	円熟味
えんしゅつ	演出
えんじょ	援助
えんしょう	延焼
えんしょう	炎症
えんじょう	炎上
えんじん	円陣
えんしんりょく	遠心力
えんすい	円錐
えんずい	延髄
えんすいだい	円錐台
えんせい	厭世
えんせい	延性
えんせい	遠征
えんせき	宴席
えんぜつ	演説
えんせん	沿線
えんぜん	艶然
えんそう	演奏
えんそく	遠足
えんたい	延滞
えんだか	円高
えんたく	円卓
えんだん	演壇
えんだん	縁談
えんちゃく	延着
えんちゅう	円柱
えんちょう	園長
えんちょう	延長
えんちょく	鉛直
えんてんか	炎天下
えんとう	円筒
えんどう	沿道
えんどお	縁遠
えんとつ	煙突
えんにち	縁日
えんねつ	炎熱
えんのした	縁の下
えんばん	円盤
えんび	塩ビ
えんぴつ	鉛筆
えんびふく	燕尾服
えんぶん	艶聞
えんぶん	塩分
えんぽう	遠方
えんまく	煙幕
えんまちょう	閻魔帳
えんまん	円満
えんむすび	縁結び
えんめい	延命
えんもく	演目
えんやす	円安
えんよう	援用
えんよう	遠洋
えんらい	遠来
えんりょ	遠慮
えんろ	遠路
お	圧
お	於
お	押
お	居
お	緒
お	織
お	推
お	折
お	置
お	逐
お	追
お	尾
お	負
おあいて	お相手
おあいて	御相手
おあらため	お改め
おい	甥
おい	老い
おいかけ	追いかけ
おいかけ	追い掛け
おいかけまわ	追いかけ回
おいかけまわ	追い掛け回
おいこ	追いこ
おいこ	追い越
おいこ	追い込
おいこ	老い込
おいし	美味し
おいしげ	生い茂
おいそがしい	お忙しい
おいだ	追い出
おいたち	生い立ち
おいたて	追いたて
おいたて	追い立て
おいつ	追い付
おいつめ	追い詰め
おいぬ	追い抜
おいのり	お祈り
おいはら	追い払
おいぼれ	老いぼれ
おいめ	負い目
おいもとめ	追い求め
おいる	オイル
おいわい	お祝い
おいわい	御祝い
おう	応
おう	王
おうい	王位
おういつ	横溢
おういん	押印
おういん	押韻
おうえん	応援
おうおう	往々
おうおうにして	往々にして
おうか	押下
おうか	欧化
おうか	桜花
おうかくまく	横隔膜
おうかん	往還
おうかん	王冠
おうぎ	扇
おうきゅう	応急
おうきゅう	王宮
おうけとり	お受け取り
おうこう	横行
おうこう	王侯
おうこく	王国
おうごん	黄金
おうざ	王座
おうさつ	応札
おうさま	王様
おうし	牡牛
おうじ	往時
おうじ	王子
おうしつ	王室
おうじゃ	王者
おうしゅう	応酬
おうしゅう	押収
おうしょう	王将
おうじょう	往生
おうしょく	黄色
おうしん	往信
おうしん	往診
おうせい	旺盛
おうせい	王制
おうせつ	応接
おうせん	応戦
おうたい	応対
おうだく	応諾
おうだん	横断
おうち	樗
おうちゃく	横着
おうちょう	王朝
おうて	王手
おうてん	横転
おうどいろ	黄土色
おうとう	応答
おうどう	王道
おうどう	黄銅
おうとつ	凹凸
おうなつ	押捺
おうねん	往年
おうのう	懊悩
おうはん	凹版
おうひ	王妃
おうふう	欧風
おうふく	往復
おうぶん	欧文
おうへい	横柄
おうへん	黄変
おうぼ	応募
おうほう	応報
おうぼう	横暴
おうむ	鸚鵡
おうよう	応用
おうよう	鷹揚
おうらい	往来
おうりょう	横領
おうりょく	応力
おうろ	往路
おえ	終え
おえかき	お絵書き
おえつ	嗚咽
おえらがた	お偉方
おお	多
おお	被
おお	覆
おおあめ	大雨
おおい	大い
おおいし	大石
おおいそぎ	大急ぎ
おおいなる	大いなる
おおいに	大いに
おおいり	大入
おおうりだし	大売出し
おおおとこ	大男
おおがかり	大がかり
おおがかり	大掛かり
おおかぜ	大風
おおかた	大方
おおがた	大型
おおがた	大形
おおがたき	大型機
おおかみ	狼
おおかわ	大川
おおき	大き
おおきな	大きな
おおきに	大きに
おおく	多く
おおくち	大口
おおぐち	大口
おおくもの	多くもの
おおくら	大蔵
おおくり	お送り
おおげさ	大げさ
おおげさ	大袈裟
おおごえ	大声
おおざっぱ	大雑把
おおさめ	お納め
おおさわぎ	大騒ぎ
おおし	雄々し
おおしま	大島
おおすじ	大筋
おおずもう	大相撲
おおせ	仰せ
おおぜい	大勢
おおぜき	大関
おおせつか	仰せつか
おおぞら	大空
おおたき	大滝
おおづめ	大詰め
おおで	大手
おおどおり	大通り
おおどしま	大年増
おおとり	鴻
おおとり	鳳
おおとり	鵬
おおなみ	大波
おおはし	大橋
おおはば	大幅
おおばん	大判
おおびけ	大引け
おおまか	大まか
おおまがり	大曲
おおまた	大股
おおまちがい	大間違い
おおみず	大水
おおみそか	大晦日
おおむかし	大昔
おおむね	概ね
おおめ	大目
おおもじ	大文字
おおもと	大本
おおもの	大物
おおもり	大盛り
おおや	大家
おおやけ	公
おおやすうり	大安売り
おおやま	大山
おおゆき	大雪
おおわらい	大笑い
おおわらわ	大童
おか	岡
おか	丘
おか	侵
おか	犯
おか	冒
おが	拝
おかあさま	お母様
おかあさん	お母さん
おかえし	お返し
おかげ	お蔭
おかげ	御蔭
おかげさま	お蔭様
おかげさま	御蔭様
おかげん	お加減
おかし	可笑し
おかじょうき	陸蒸気
おかって	お勝手
おかっぴき	岡っ引き
おかどちがい	お門違い
おかね	お金
おかぼ	陸稲
おかもち	岡持ち
おかり	お刈り
おかり	お狩り
おがわ	小川
おかわり	お代り
おかわり	お変り
おかわり	お変わり
おかん	悪寒
おき	沖
おき	起き
おぎ	荻
おきあい	沖合い
おきあが	起き上が
おきかえ	置き換え
おきかえ	置換え
おきかわ	置き換わ
おきざり	置き去り
おきて	掟
おきな	翁
おぎな	補
おきにいり	お気に入り
おきば	置場
おきもち	お気持
おきもの	置物
おきゃく	お客
おきゃくさま	お客様
おきわすれ	置き忘れ
おく	奥
おく	億
おく	臆
おく	送
おく	贈
おくがい	屋外
おくぎ	奥義
おくさま	奥様
おくさん	奥さん
おくじょう	屋上
おくそく	憶測
おくそこ	奥底
おくち	奥地
おくない	屋内
おくにがら	お国柄
おくば	奥歯
おくびょう	臆病
おくめん	臆面
おくやま	奥山
おくやみ	お悔やみ
おくゆかし	奥ゆかし
おくゆき	奥行き
おくら	遅ら
おぐら	小倉
おくらせ	遅らせ
おくりがな	送り仮名
おくりこ	送り込
おくりさき	送り先
おくりじょう	送り状
おくりだ	送り出
おくりとどけ	送り届け
おくりぬし	送り主
おくりむかえ	送り迎え
おくりもの	贈物
おくれ	後れ
おくれ	遅れ
おくればせながら	遅ればせながら
おけ	桶
おけいこ	お稽古
おこ	起こ
おこ	興
おこ	怒
おこさま	お子様
おこさん	お子さん
おこし	お越し
おごそか	厳か
おこた	怠
おこたえ	お答え
おことわり	お断り
おことわり	お断わり
おこな	行
おこな	行な
おさえ	押え
おさえ	押さえ
おさえ	抑え
おさえこ	押え込
おさえこ	抑え込
おさきに	お先に
おさそい	お誘い
おさな	幼
おさなご	幼子
おさま	治ま
おさま	収ま
おさま	修ま
おさま	納ま
おさめ	治め
おさめ	収め
おさめ	修め
おさめ	納め
おし	押し
おし	惜し
おじ	叔父
おじ	小父
おじ	伯父
おしあげ	押し上げ
おしあわせ	お幸せ
おしい	押し入
おじいさん	お爺さん
おしいれ	押入
おしうり	押売
おしえ	教え
おしかえ	押し返
おしかけ	押しかけ
おしき	押し切
おしくも	惜しくも
おしこ	押し込
おしごと	お仕事
おしこめ	押し込め
おしずまり	お鎮まり
おしだ	押し出
おしつけ	押しつけ
おしつけ	押し付け
おしつま	押し詰ま
おしとお	押し通
おしどり	鴛鴦
おしのけ	押し退け
おしはか	推し量
おしみな	惜しみな
おしむらくは	惜しむらくは
おしゃれ	お洒落
おしょう	和尚
おじょうさま	お嬢様
おじょうさん	お嬢さん
おじょく	汚辱
おしょくじ	お食事
おしよせ	押し寄せ
おしらせ	お知らせ
おしろい	白粉
おしんこ	お新香
おす	牡
おす	雄
おすい	汚水
おすまい	お住い
おすみつき	お墨付き
おせいぼ	御歳暮
おせっかい	お節介
おせわ	お世話
おせん	汚染
おそ	襲
おそ	遅
おそくとも	遅くとも
おそざき	遅咲き
おそし	遅し
おぞまし	鈍まし
おぞまし	悍まし
おそらく	恐らく
おそらくは	恐らくは
おそらし	お反らし
おそるべき	恐るべき
おそれ	恐れ
おそれ	虞
おそれい	恐れ入
おそれながら	恐れながら
おそろいで	お揃いで
おそろし	恐ろし
おそわ	教わ
おそん	汚損
おたがい	お互い
おたがいに	お互いに
おだく	汚濁
おたけび	雄叫び
おたずね	お尋ね
おたち	お裁ち
おたち	お発ち
おたっし	お達し
おだて	煽て
おだやか	穏やか
おたより	お便り
おち	堕ち
おち	墜ち
おち	落ち
おちあ	落ち合
おちい	陥
おちこ	落ち込
おちつ	落ち着
おちど	落度
おちば	落葉
おちぶれ	落ちぶれ
おちゃ	お茶
おちゅうげん	御中元
おつ	乙
おつかい	お使い
おっかけ	追っかけ
おつき	お附き
おつぎ	お接ぎ
おっくう	億劫
おつげ	お告げ
おっこち	落っこち
おつたえ	お伝え
おつつしみ	お謹み
おつつしみ	お慎み
おって	追って
おって	追っ手
おって	追手
おっと	夫
おてあげ	お手上げ
おでかけ	お出かけ
おてすう	お手数
おてほん	お手本
おてま	お手間
おてまえ	お点前
おてん	汚点
おでんわ	お電話
おと	音
おと	落
おと	落と
おと	劣
おど	脅
おど	躍
おど	踊
おとうさん	お父さん
おとうと	弟
おどか	脅か
おとこ	男
おとこで	男手
おとこのこ	男の子
おとこらし	男らし
おとさた	音沙汰
おとし	お年
おとしいれ	陥れ
おとしもの	落し物
おとづれ	訪れ
おととい	一昨日
おととし	一昨年
おとな	大人
おとなげな	大人げな
おとなし	大人し
おとなび	大人び
おとめ	乙女
おとりあつかい	お取り扱い
おとりあつかい	お取扱い
おとりこみちゅう	お取り込み中
おとりしらべ	お取り調べ
おとりはからい	お取り計らい
おとりひき	お取り引き
おどろ	驚
おとろえ	衰え
おどろか	驚か
おないどし	同い年
おなか	お腹
おなが	尾長
おながどり	尾長鶏
おなじ	同じ
おなじく	同じく
おなじみ	お馴染み
おなじよう	同じよう
おなまえ	お名前
おに	鬼
おにいさん	お兄さん
おね	尾根
おねえさん	お姉さん
おねがい	お願い
おねたみ	お妬み
おの	斧
おのおの	各々
おのずから	自ずから
おのずと	自ずと
おのれ	己
おば	叔母
おば	小母
おば	伯母
おばあさん	お婆さん
おばけ	お化け
おはなし	お話
おび	帯
おび	帯び
おひきうけ	お引受け
おひきたて	お引き立て
おひさしぶり	お久しぶり
おびじょう	帯状
おびただし	夥し
おひとよし	お人好し
おひとよし	御人好し
おびやか	脅か
おひれ	尾ひれ
おひろめ	お披露目
おぶつ	汚物
おふれ	お触れ
おへや	お部屋
おへんじ	お返事
おへんじ	御返事
おぼえ	憶え
おぼえ	覚え
おぼえがき	覚書
おぼし	思し
おぼれ	溺れ
おぼろ	朧ろ
おまいり	お参り
おまいり	御参り
おまえ	お前
おまごさん	お孫さん
おまち	お待ち
おまつり	お祭り
おまもり	お守り
おまわり	お巡り
おみき	お神酒
おみまい	お見舞
おみまい	御見舞
おめい	汚名
おめいし	お名刺
おめにかか	お目にかか
おも	思
おも	主
おも	重
おも	想
おもいあた	思い当た
おもいいた	思い至
おもいおこ	思い起こ
おもいかえ	思い返
おもいがけな	思いがけな
おもいき	思い切
おもいきや	思いきや
おもいこ	思い込
おもいし	思い知
おもいた	思い立
おもいだ	思いだ
おもいだ	思い出
おもいちがい	思い違い
おもいつ	思いつ
おもいつ	思い付
おもいつめ	思い詰め
おもいで	思い出
おもいで	想い出
おもいなお	思い直
おもいのこ	思い残
おもいや	思いや
おもうしこみ	お申し込み
おもおもし	重々し
おもかげ	面影
おもくるし	重苦し
おもざし	面差し
おもしろ	面白
おもた	重た
おもちゃ	玩具
おもて	表
おもて	面
おもてがき	表書き
おもてがわ	表側
おもてぐち	表口
おもてじ	表地
おもてむき	表向き
おもに	主に
おもに	重荷
おもね	阿
おもはゆ	面映
おもみ	重み
おもむ	赴
おもむき	趣
おももち	面持ち
おもや	母屋
おもり	重り
おもり	錘
おもわく	思惑
おもわし	思わし
おもわず	思わず
おもん	重ん
おもんぱか	慮
おや	親
おやかた	親方
おやくそく	お約束
おやこ	親子
おやこうこう	親孝行
おやじ	親父
おやだま	親玉
おやばか	親馬鹿
おやふこう	親不孝
おやぶん	親分
おやもと	親元
おやゆび	親指
おゆ	お湯
おゆき	お逝き
おゆるし	お許し
およ	泳
およ	及
および	お呼び
および	及び
およびごし	及び腰
およぼ	及ぼ
おより	お撚り
およろこび	お喜び
およろこび	お慶び
おり	下り
おり	降り
おり	折
おり	澱
おり	檻
おりあ	折り合
おりおり	折々
おりかえ	折り返
おりかさな	折り重な
おりがみ	折り紙
おりこ	織り込
おりこ	折り込
おりこみ	折込
おりしも	折しも
おりたた	折り畳
おりめ	折り目
おりもの	織物
おれ	俺
おれ	折れ
おれい	お礼
おれい	御礼
おれせん	折れ線
おれたち	俺達
おれまが	折れ曲が
おろ	卸
おろ	下ろ
おろ	降ろ
おろか	愚か
おろかし	愚かし
おろし	卸
おろしうり	卸売
おろしそうば	卸相場
おろしね	卸値
おろそか	疎か
おわ	終
おわ	終わ
おわい	汚穢
おわび	お詫び
おわり	終
おん	恩
おん	音
おんいん	音韻
おんかい	音階
おんがえし	恩返し
おんがく	音楽
おんかん	音感
おんきゅう	恩給
おんきょう	音響
おんけい	恩恵
おんけん	穏健
おんこ	恩顧
おんこう	温厚
おんし	恩師
おんし	恩賜
おんしつ	温室
おんしつ	音質
おんしゃ	恩赦
おんしゃ	御社
おんじゅん	温順
おんしょう	恩賞
おんしょう	温床
おんじょう	温情
おんじょう	音声
おんしん	音信
おんじん	恩人
おんすい	温水
おんせい	音声
おんせつ	音節
おんそ	音素
おんぞう	音像
おんぞうし	御曹司
おんそく	音速
おんぞん	温存
おんたい	温帯
おんだん	温暖
おんち	音痴
おんちゅう	御中
おんてい	音程
おんてん	恩典
おんど	温度
おんど	音頭
おんとう	穏当
おんどけい	温度計
おんな	女
おんなのこ	女の子
おんならし	女らし
おんねつ	温熱
おんねん	怨念
おんぱ	音波
おんびん	穏便
おんびん	音便
おんぷ	音符
おんぷう	温風
おんみつ	隠密
おんみょう	陰陽
おんよく	温浴
おんよみ	音読み
おんりょう	音量
おんれい	御礼
おんわ	温和
おんわ	穏和
か	化
か	可
か	嫁
か	科
か	果
か	架
か	課
か	蚊
か	穫
か	噛
か	刈
か	苅
か	駆
か	欠
か	香
か	飼
か	狩
か	書
か	勝
か	掻
か	貸
か	買
か	描
が	我
が	画
が	臥
が	蛾
が	賀
が	駕
かあさん	母さん
かあちゃん	母ちゃん
かい	下位
かい	介
かい	会
かい	解
かい	回
かい	怪
かい	界
かい	階
かい	貝
かい	甲斐
がい	害
がい	概
がい	該
かいあく	改悪
がいあく	害悪
かいあげ	買い上げ
がいあつ	外圧
かいい	怪異
かいい	魁偉
かいいき	海域
かいいれ	買い入れ
かいいん	会員
かいいん	改印
かいいん	海員
かいいん	開院
がいいん	外因
かいいんせい	会員制
かいうん	海運
かいうん	開運
かいえん	開園
かいえん	開宴
かいえん	開演
がいえん	外延
がいえん	外縁
かいおき	買い置き
かいか	開化
かいか	開花
かいか	階下
かいが	絵画
がいか	凱歌
がいか	外貨
かいかい	開会
かいがい	海外
がいかい	外界
かいかえ	買い替え
かいかく	改革
がいかく	外角
がいかく	外郭
かいかけ	買掛
かいかつ	快活
がいかつ	概括
かいがら	貝殻
かいかん	会館
かいかん	会舘
かいかん	快感
かいかん	開館
かいがん	海岸
かいがん	開眼
がいかん	外患
がいかん	外観
がいかん	概観
かいがんせん	海岸線
かいき	会期
かいき	回忌
かいき	回帰
かいき	快気
かいき	怪奇
かいき	皆既
かいき	買い切
かいぎ	会議
かいぎ	懐疑
がいき	外気
かいきしょく	皆既食
かいきせん	回帰線
かいぎゃく	諧謔
かいきゅう	懐旧
かいきゅう	階級
かいきょ	快挙
かいきょう	回教
かいきょう	海峡
かいぎょう	改行
かいぎょう	開業
がいきょう	概況
かいぎょうい	開業医
かいきょく	開局
がいきょく	外局
かいきん	解禁
かいきん	皆勤
かいきん	開襟
がいきん	外勤
かいぐい	買い食い
かいぐん	海軍
かいけい	会計
がいけい	外形
かいけつ	解決
かいけつさく	解決策
かいけん	会見
かいけん	改憲
かいげん	戒厳
かいげん	改元
がいけん	外見
かいげんれい	戒厳令
かいこ	解雇
かいこ	回顧
かいこ	懐古
かいこ	蚕
かいこ	買い込
かいご	介護
がいご	外語
かいこう	回航
かいこう	改稿
かいこう	海港
かいこう	海溝
かいこう	開校
かいこう	開港
かいこう	邂逅
かいごう	会合
がいこう	外交
がいこう	外向
がいこうかん	外交官
かいこく	悔告
かいこく	開国
がいこく	外国
がいこつ	骸骨
かいこん	悔恨
かいこん	開墾
かいさ	階差
かいさい	開催
かいざい	介在
がいさい	外債
がいざい	外材
かいさく	改作
かいさつ	改札
かいさん	解散
かいざん	改竄
かいざん	海山
がいさん	概算
かいさんぶつ	海産物
かいし	会誌
かいし	開始
かいじ	快事
かいじ	開示
がいし	外紙
がいし	外資
がいし	碍子
がいじ	外字
かいしつ	開室
かいしめ	買い占め
かいしめ	買占め
かいしゃ	会社
がいしゃ	会社
がいしゃ	外車
かいしゃいん	会社員
かいしゃく	介錯
かいしゃく	解釈
がいじゅ	外需
かいしゅう	回収
かいしゅう	改修
かいじゅう	怪獣
かいじゅう	懐柔
かいじゅう	晦渋
がいしゅう	外周
かいしゅうごう	開集合
がいしゅつ	外出
かいしゅん	回春
かいしゅん	改悛
かいしょ	会所
かいしょ	楷書
かいじょ	解除
かいしょう	解消
かいしょう	改称
かいしょう	甲斐性
かいじょう	会場
かいじょう	海上
かいじょう	開場
かいじょう	階上
がいしょう	外傷
がいしょう	外相
かいしょく	会食
かいしょく	解職
がいしょく	外食
かいしん	会心
かいしん	回診
かいしん	改心
かいしん	改新
がいしん	外信
がいしん	外心
がいじん	外人
かいしんげき	快進撃
かいすい	海水
かいすいよく	海水浴
かいすう	回数
かいすう	階数
がいすう	概数
かいせい	回生
かいせい	快晴
かいせい	改姓
かいせい	改正
がいせい	外征
がいせい	外声
かいせき	会席
かいせき	解析
かいせき	懐石
がいせき	外戚
がいせき	外積
かいせつ	解説
かいせつ	開設
がいせつ	外接
がいせつ	概説
かいせん	会戦
かいせん	回旋
かいせん	回線
かいせん	改選
かいせん	開戦
かいぜん	改善
がいせん	凱旋
がいせん	外線
かいそ	改組
かいそ	開祖
かいそう	会葬
かいそう	回想
かいそう	回送
かいそう	快走
かいそう	改装
かいそう	海草
かいそう	海藻
かいそう	階層
かいぞう	改造
がいそう	外層
がいそう	外挿
かいぞうど	解像度
かいそく	会則
かいそく	快速
かいぞく	海賊
かいたい	解体
かいたい	懐胎
かいだい	解題
かいだい	改題
かいたく	開拓
かいだく	快諾
かいだめ	買い溜め
がいためほう	外為法
かいだん	会談
かいだん	怪談
かいだん	階段
がいたん	慨嘆
かいちく	改築
かいちゅう	懐中
かいちゅう	海中
がいちゅう	外注
がいちゅう	害虫
かいちょう	会長
かいちょう	快調
かいちょう	階調
かいつう	開通
かいづか	貝塚
かいつけ	買付け
かいて	買い手
かいてい	改定
かいてい	改訂
かいてい	海底
かいてい	開廷
かいてい	階梯
かいてき	快適
がいてき	外敵
がいてき	外的
かいてん	回転
かいてん	開店
かいでん	皆伝
がいでん	外伝
がいでん	外電
かいと	買い取
がいど	ガイド
かいとう	会頭
かいとう	解凍
かいとう	解答
かいとう	回答
かいどう	会堂
かいどう	街道
がいとう	外灯
がいとう	街灯
がいとう	街頭
がいとう	該当
かいどく	解読
かいどく	買い得
がいどく	害毒
かいなら	飼い慣ら
かいなん	海難
かいにゅう	介入
かいにん	解任
かいにん	懐妊
かいぬし	飼い主
かいね	買値
がいねん	概念
かいはい	改廃
がいはく	外泊
かいはくしょく	灰白色
かいはつ	開発
かいばつ	海抜
かいはつぶ	開発部
かいはん	改版
かいひ	会費
かいひ	回避
かいび	快美
がいひ	外皮
かいひふく	開被覆
かいびゃく	開闢
かいひょう	開票
がいひょう	概評
かいひん	海浜
かいふ	回付
がいぶ	外部
かいふう	開封
かいふく	回復
かいふく	快復
かいぶつ	怪物
がいぶん	外聞
かいぶんしょ	怪文書
かいへい	開平
かいへい	開閉
かいぺーじ	改ページ
がいへき	外壁
かいへん	改変
かいへん	改編
かいほう	介抱
かいほう	会報
かいほう	解放
かいほう	快方
かいほう	開放
かいぼう	解剖
がいまい	外米
かいまく	開幕
かいまみ	かいま見
かいみん	快眠
かいむ	会務
かいむ	皆無
がいむ	外務
かいめい	解明
かいめい	改名
かいめい	開明
かいめつ	壊滅
かいめん	海棉
かいめん	海面
かいめん	界面
がいめん	外面
かいもく	皆目
かいもど	買い戻
かいもの	買いもの
かいもの	買物
かいもん	開門
がいや	外野
かいやく	解約
かいやく	改訳
かいゆ	快癒
かいゆう	回遊
がいゆう	外遊
かいよう	海洋
かいよう	潰瘍
がいよう	概要
かいらい	傀儡
がいらい	外来
かいらく	快楽
かいらん	回覧
がいらん	外乱
かいり	乖離
かいりく	海陸
がいりゃく	概略
かいりゅう	海流
かいりょう	改良
がいりょく	外力
がいりん	外輪
かいれい	海嶺
かいろ	回路
かいろ	懐炉
かいろ	海路
がいろ	街路
かいろう	回廊
がいろん	概論
かいわ	会話
かいわい	界隈
かいん	下院
かえ	換え
かえ	帰
かえ	替え
かえ	代え
かえ	変え
かえ	返
かえだま	替玉
かえって	却って
かえで	楓
がえり	帰り
かえりざ	返り咲
かえりざき	返咲き
かえりみ	顧み
かえりみ	省み
かえる	蛙
かえん	火炎
かえん	火焔
がえん	肯ん
がえんじ	肯んじ
かお	顔
かお	薫
かお	香
かおあわせ	顔合せ
かおいろ	顔色
かおく	家屋
かおだち	顔立ち
かおぶれ	顔ぶれ
かおみしり	顔見知り
かおむけ	顔向け
かおやく	顔役
かか	架か
かか	掛か
かか	係
かか	欠か
かか	懸か
かが	屈
がか	画家
かかい	下界
かがい	加害
かがい	課外
がかい	瓦解
かかえ	抱え
かかく	価格
かがく	化学
かがく	科学
ががく	雅楽
かかげ	掲げ
かかし	案山子
かかと	踵
かがみ	鏡
かがや	輝
かがやか	輝か
かがやかし	輝かし
かかり	係
かかりいん	係員
かかりかん	係官
かかりちょう	係長
かかわ	関
かかわ	関わ
かかわ	係わ
かかわ	拘
かかん	果敢
かかんそく	可観測
かき	牡蛎
かき	下記
かき	夏期
かき	夏季
かき	火気
かき	花器
かき	花卉
かき	垣
かき	柿
かき	蛎
かき	堵
かぎ	鈎
かぎ	鍵
かぎ	限
かきあげ	かき揚げ
かきあげ	書き上げ
かきあつめ	かき集め
かきあらわ	書き表
かきいれ	書き入れ
かきいれどき	書き入れ時
かきお	書き置
かきおき	書置
かきおと	書き落と
かきおろ	書き下ろ
かきかえ	書き換え
かきかえ	書換え
かきかた	書き方
かぎかっこ	鈎括弧
かきくだ	書き下
かきけ	かき消
かきこ	書き込
かきこみけん	書き込み権
かきそえ	書き添え
かきぞめ	書初め
かきだ	書き出
かきたて	書き立て
かきつけ	書き付け
かきつけ	書付け
かきつばた	杜若
かきつらね	書き連ね
かきと	書き取
かきとめ	書き留め
かきとめ	書留
かきとり	書取
かきぬ	書き抜
かきね	垣根
かきのこ	書き残
かきまぜ	かき混ぜ
かきまわ	かき回
かきみだ	かき乱
かぎゃく	加虐
かぎゃく	可逆
かぎゃく	苛虐
かきゃくせん	貨客船
かきゅう	下級
かきゅう	火急
かきょう	佳境
かきょう	家教
かきょう	架橋
かきょう	華僑
かぎょう	家業
かぎょう	稼業
かきょく	歌曲
かきよせ	かき寄せ
かぎりな	限りな
かきわけ	かき分け
かきん	課金
かく	隠
かく	画
かく	各
かく	格
かく	核
かく	殻
かく	確
かく	角
かぐ	家具
がく	学
がく	額
かくあげ	格上げ
かくい	各位
がくい	学位
かくいつてき	画一的
かくいん	各員
かくいん	客員
がくいん	学院
かくう	架空
かくうんどうりょう	角運動量
かくえき	各駅
がくえん	学園
かくか	各課
かくかい	各階
かくかぞく	核家族
かくぎ	閣議
がくぎょう	学業
がくげい	学芸
がくげき	楽劇
かくげつ	隔月
かくげつかん	隔月刊
かくけん	各県
かくげん	格言
かくげん	確言
かくご	覚悟
かくこう	各校
かくこう	各項
かくさ	格差
かくざい	角材
がくさい	学才
かくさく	画策
かくさげ	格下げ
かくざとう	角砂糖
かくさん	拡散
かくさん	核酸
かくし	各市
かくし	各紙
かくし	客死
かくじ	各自
がくし	学士
がくし	学資
かくしき	格式
がくしき	学識
かくしつ	各室
かくしつ	確執
かくしつ	角質
かくじつ	確実
かくじつ	隔日
かくじっけん	核実験
かくしゃ	各社
がくしゃ	学者
かくしゃく	矍鑠
かくしゅ	各種
かくしゅう	各週
かくしゅう	確執
かくしゅう	隔週
かくじゅう	拡充
がくしゅう	学習
がくじゅつ	学術
かくしょ	各所
かくしょ	各署
かくしょう	確証
がくしょう	楽章
かくしょうちょう	各省庁
かくじょし	格助詞
かくしん	核心
かくしん	確信
かくしん	革新
かくじん	各人
かくすう	画数
かくせい	拡声
かくせい	覚醒
かくせい	隔世
がくせい	学制
がくせい	学生
かくせいざい	覚醒剤
がくせき	学籍
かくぜつ	隔絶
がくせつ	学説
かくせん	各線
かくぜん	画然
がくぜん	愕然
かくせんそう	核戦争
かくそう	各層
がくそう	学窓
がくそく	学則
がくそつ	学卒
かくだい	拡大
がくたい	楽隊
かくだん	格段
がくだん	楽団
かくち	各地
かくちゅう	角柱
かくちょう	拡張
かくちょう	格調
がくちょう	学長
かくちょうし	拡張子
かくつき	各月
かくづけ	格付け
かくてい	確定
がくてき	学的
かくてん	各店
かくてん	各点
かくど	確度
かくど	角度
かくとう	各党
かくとう	格闘
かくとう	確答
がくどう	学堂
がくどう	学童
がくどう	楽堂
かくとく	獲得
かくない	閣内
がくない	学内
かくにん	確認
かくねん	隔年
がくねん	学年
かくのう	格納
かくは	各派
がくばつ	学閥
かくはん	各般
がくひ	学費
かくぶ	各部
がくふ	楽譜
がくぶ	学部
がくぶち	額縁
かくぶんれつ	核分裂
かくへいき	核兵器
かくへき	隔壁
かくべつ	格別
かくほ	確保
かくほう	確報
かくまく	角膜
がくむ	学務
かくめい	革命
がくめい	学名
かくめん	各面
がくめん	額面
がくもん	学問
がくや	楽屋
かくやく	確約
かくやす	格安
がくゆう	学友
かくゆうごう	核融合
がくようひん	学用品
かぐら	神楽
かくらん	撹乱
かくり	隔離
かくりつ	確率
かくりつ	確立
かくりょう	閣僚
がくりょく	学力
かくれ	隠れ
かくれが	隠れ家
がくれき	学歴
かくろん	各論
がくわり	学割
かけ	架け
かけ	掛け
かけ	駆け
かけ	駈け
かけ	欠け
かけ	懸け
かけ	賭
かけ	賭け
かけ	翔け
かげ	蔭
かげ	陰
かげ	影
かげ	翳
がけ	崖
かけあ	掛け合
かけあし	駆け足
かけあわ	掛け合わ
かけい	家系
かけい	家計
かけいぼ	家計簿
かげえ	影絵
かけおち	駆け落ち
かけおち	駆落ち
かげき	歌劇
かげき	過激
かけきん	掛金
かげぐち	陰口
かけこ	駆け込
かけごえ	かけ声
かけごと	賭事
かけざん	かけ算
かけざん	掛け算
かけざん	掛算
かけじく	掛軸
かけず	掛図
かけずりまわ	駆けずりまわ
かけずりまわ	駆けずり回
かけだ	駆け出
かけつ	可決
かけつけ	駆けつけ
がけっぷち	崖っ淵
かけぬけ	駆け抜け
かけね	掛け値
かけのぼ	駆け登
かけはし	架け橋
かけはなれ	かけ離れ
かけはなれ	懸け離れ
かけはなれ	懸離れ
かけひき	駆け引き
かけひき	駆引き
かけへだて	かけ隔て
かげぼし	陰干し
かけまわ	駆け回
かけも	掛け持
かけもち	掛持ち
かけよ	駆け寄
かけよ	駆寄
かげろう	陽炎
かげん	下弦
かげん	下限
かげん	加減
かげんじょうじょ	加減乗除
かげんち	下限値
かこ	囲
かこ	過去
かご	加護
かご	篭
かご	籠
かこう	下降
かこう	加工
かこう	河口
かこう	火口
かごう	化合
がごう	雅号
かこうがん	花崗岩
かこうせん	下降線
かごうぶつ	化合物
かこく	苛酷
かこく	過酷
かこん	禍根
かごん	過言
かさ	笠
かさ	傘
かさ	嵩
かさ	暈
かざ	飾
かさい	家裁
かさい	火災
かざい	家財
がさい	画才
がざい	画材
かさいりゅう	火砕流
かざかみ	風上
かさく	佳作
かさく	家作
かさく	寡作
かざぐるま	風車
かざしも	風下
かさな	重な
かさね	重ね
かさねがさね	重ね重ね
かさねて	重ねて
かざみ	風見
かざみどり	風見鶏
かざむき	風向き
かざりつけ	飾り付け
かさん	加算
かざん	火山
かざんばい	火山灰
かし	仮死
かし	可視
かし	歌詞
かし	河岸
かし	華氏
かし	菓子
かし	樫
かし	傾
かし	炊
かし	貸し
かし	瑕疵
かじ	家事
かじ	火事
かじ	舵
かじ	鍛冶
がし	餓死
かじか	鰍
かじか	杜父魚
かじか	鮖
かしかた	貸方
かしかん	下士官
かしきり	貸切り
かしきん	貸し金
かしげ	傾げ
かしこ	賢
かしこ	貸し越
かしこう	可視光
かしこま	畏ま
かしだ	貸し出
かしだし	貸出
かしちん	貸賃
かしつ	加湿
かしつ	過失
かじつ	佳日
かじつ	果実
かじつ	過日
がしつ	画質
かしつけ	貸し付け
かしほん	貸本
かしま	貸間
かしまし	姦し
かしゃ	貨車
かしや	貸家
かしゃく	呵責
かしゅ	歌手
かじゅ	果樹
がしゅ	雅趣
かしゅう	歌集
かじゅう	加重
かじゅう	果汁
かじゅう	荷重
かじゅう	過重
がしゅう	画集
かしょ	箇所
かしょ	個所
かじょ	加除
かしょう	仮称
かしょう	歌唱
かしょう	過小
かしょう	過少
かじょう	箇条
かじょう	過剰
がしょう	画商
がしょう	賀正
がじょう	牙城
がじょう	画帖
がじょう	賀状
かじょうがき	箇条書
かしょく	華燭
かしょく	過食
かしょくしょう	過食症
かしょくのてん	華燭の典
かしら	頭
かしわ	柏
かしわもち	柏餅
かしん	家臣
かしん	過信
かじん	歌人
がしんしょうたん	臥薪嘗胆
かじんはくめい	佳人薄命
かす	霞
かす	糟
かす	粕
かす	掠
かず	下図
かず	数
がす	瓦斯
かすい	下垂
かすう	仮数
かずおお	数多
かずおおく	数多く
かすか	微か
かすが	春日
かずかず	数々
かずすくな	数少な
かすたむか	カスタム化
かずのこ	数の子
かずのこ	鯑
かすみ	霞
かずら	葛
かせ	稼
かせ	枷
かぜ	風
かぜ	風邪
かせい	化成
かせい	仮性
かせい	加勢
かせい	家政
かぜい	課税
かせき	化石
かせつ	仮設
かせつ	仮説
かせつ	架設
かぜむき	風向き
かせん	下線
かせん	化繊
かせん	寡占
かせん	架線
かせん	河川
がぜん	俄然
がせんし	画仙紙
かそ	過疎
かそう	下層
かそう	仮想
かそう	仮装
かそう	火葬
かぞう	家蔵
がぞう	画像
かぞえ	数え
かそく	加速
かぞく	家族
かぞく	華族
かぞくづれ	家族連れ
かそくど	加速度
かた	過多
かた	潟
かた	型
かた	形
かた	堅
かた	肩
かた	固
かた	語
かた	硬
かた	難
かた	片
かた	方
がた	型
がた	方
かたあし	片足
かだい	仮題
かだい	課題
かだい	過大
がだい	画題
かたいれ	肩入れ
かたうで	片腕
かたおもい	片思い
かたおもい	片想い
かたがき	肩書
かたがた	方々
かたかな	片仮名
かたがみ	型紙
かたがわ	片側
かたがわり	肩代り
かたぎ	気質
かたぎ	堅気
かたきうち	敵討ち
かたく	仮託
かたく	家宅
かたくずれ	型くずれ
かたくり	片栗
かたくりこ	片栗粉
かたくるし	堅苦し
かたこと	片言
かたこり	肩こり
かたず	固唾
かたすみ	片隅
かたち	形
かたちづく	形作
かたづ	片付
かたづけ	片付け
かたっぱし	片っ端
かたて	片手
かたてま	片手間
かたど	象
かたど	模
かたどおり	型どおり
かたとき	片時
かたな	刀
かたはし	片端
かたはば	肩幅
かたばん	型番
かたぶつ	堅物
かたほう	片方
かたま	固ま
かたまり	塊
かたみ	形見
かたみ	肩身
かたみ	片身
かたみち	片道
かたむ	傾
かため	堅め
かため	固め
かため	片目
かためん	片面
かたやぶり	型破り
かたよ	偏
かたら	語ら
かたり	語り
かたりあ	語り合
かたりつ	語り継
かたわら	傍ら
かたん	下端
かたん	加担
かたん	荷担
かだん	歌壇
かだん	花壇
かち	価値
がち	勝ち
かちあ	かち合
かちかん	価値観
かちき	勝気
かちく	家畜
かちこ	勝越
かちこし	勝ち越し
かちすす	勝ち進
かちと	かち取
かちと	勝ち取
かちぬ	勝ち抜
かちぼし	勝ち星
かちまけ	勝ち負け
かちめ	勝ち目
かちゅう	渦中
かちょう	可聴
かちょう	課長
がちょう	鵞鳥
かちょうきん	課徴金
かっ	渇
かつ	活
かつ	渇
かつ	且つ
かつ	担
かつあい	割愛
かつえ	餓え
かつえ	飢え
かつお	鰹
かつおぶし	鰹節
かっか	閣下
がっか	学科
がっか	学課
かっかい	各回
かっかい	各界
がっかい	学会
がっかい	学界
がっかいし	学会誌
かっかそうよう	隔靴掻痒
かっき	活気
がっき	学期
がっき	楽器
かつぎこ	かつぎ込
かっきてき	画期的
がっきゅう	学級
かっきょ	割拠
かっきょう	活況
かっきょく	各局
がっく	学区
がっく	楽句
かっくう	滑空
かっけつ	喀血
かっこ	カッコ
かっこ	各個
かっこ	確固
かっこ	括弧
かっこう	格好
かっこう	郭公
かっこう	恰好
かっこう	滑降
がっこう	学校
かっこうほう	滑腔砲
かっこく	各国
かっさい	喝采
がっさい	合財
がっさく	合作
がっさん	合算
かつじ	活字
かっしゃ	滑車
がっしゅうこく	合州国
がっしゅうこく	合衆国
がっしゅく	合宿
かつじょう	割譲
がっしょう	合唱
がっしょう	合掌
がっしょうれんこう	合従連衡
かっしょく	褐色
かっすい	渇水
かっせい	活性
かつぜつ	滑舌
かっせん	合戦
かっそう	滑走
がっそう	合奏
かっそうろ	滑走路
がったい	合体
かったつ	闊達
がっち	合致
かって	勝手
かっと	カット
がっと	ガット
かっとう	葛藤
かつどう	活動
かっとば	かっ飛ば
かつどん	カツ丼
かっぱ	河童
かっぱ	喝破
かっぱ	合羽
かっぱつ	活発
かっぱん	活版
がっぴつ	合筆
かっぷ	割賦
かっぷく	割腹
かっぷく	恰幅
かつぶし	鰹節
がっぺい	合併
かつぼう	渇望
かっぽう	割烹
かっぽうぎ	割烹着
かつやく	活躍
かつよう	活用
かつら	桂
かつりょく	活力
かつろ	活路
かて	糧
かてい	仮定
かてい	家庭
かてい	課程
かてい	過程
かていか	家庭科
かていきょうし	家庭教師
かててくわえて	かてて加えて
かでん	瓜田
かでん	家伝
かでん	家電
かでん	荷電
かと	過渡
かど	過度
かど	角
かど	門
かとう	下等
かとう	加糖
かとう	果糖
かとう	過当
かどう	稼働
かどう	華道
かとき	過渡期
かとく	家督
かどく	可読
かどくせい	可読性
かどぐち	門口
かどち	角地
かどで	門出
かどまつ	門松
かとり	蚊取り
かな	仮名
かな	叶
かな	敵
かな	適
かなあみ	金網
かない	家内
かない	課内
かなえ	鼎
かながき	カナ書き
かながき	仮名書き
かなぐ	金具
かなし	哀し
かなし	悲し
かなた	彼方
かなづち	金槌
かなで	奏で
かなめ	要
かなもの	金物
かならず	必ず
かならずしも	必ずしも
かならずや	必ずや
かに	蟹
かにく	果肉
かにゅう	加入
かね	金
かね	兼ね
かね	鐘
かねあい	兼ね合い
かねじゃく	曲尺
かねそなえ	兼ね備え
かねつ	加熱
かねつ	過熱
かねづかい	金遣い
かねまわり	金回り
かねもうけ	金儲け
かねもち	金持ち
かのう	化膿
かのう	可能
かのうせい	可能性
かのえ	庚
かのじょ	彼女
かのと	辛
かば	樺
かば	蒲
かば	庇
がはく	画伯
かばしら	蚊柱
かばね	屍
かばね	姓
かばやき	蒲焼き
かはん	過半
かばん	鞄
がばん	画板
かはんしん	下半身
かはんすう	過半数
かひ	可否
かび	華美
かび	黴
かひつ	加筆
かひょう	下表
かびん	花瓶
かびん	過敏
かふ	下付
かふ	寡婦
かぶ	下部
かぶ	株
かぶ	被
かぶ	蕪
かふう	家風
かぶか	株価
かぶき	歌舞伎
かぶけん	株券
かぶしき	株式
かぶしきがいしゃ	株式会社
かふそく	過不足
かふちょうせい	家父長制
かぶと	兜
かぶと	甲
かぶぬし	株主
かふばん	可付番
かぶら	鏑
かぶら	蕪
かふん	花粉
かぶん	寡聞
かぶん	過分
かふんしょう	花粉症
かべ	壁
かへい	貨幣
がべい	画餅
かへん	可変
かべん	花弁
かへんちょう	可変長
かほう	家宝
かほご	過保護
かま	竃
かま	釜
かま	鎌
かま	構
かま	窯
がま	蝦蟇
がま	蒲
かまえ	構え
がまがえる	蝦蟇
がまぐち	がま口
かます	梭魚
かます	梭子魚
かまち	框
かまぼこ	蒲鉾
かまめし	釜飯
かまもと	窯元
がまん	我慢
かみ	加味
かみ	紙
かみ	守
かみ	上
かみ	神
かみ	髪
がみ	紙
かみがた	上方
かみがた	髪型
かみき	上期
かみくだ	噛み砕
かみざ	上座
かみさま	神様
かみしめ	噛みしめ
かみそり	剃刀
かみだな	神棚
かみだのみ	神頼み
かみつ	過密
かみて	上手
かみなり	雷
かみはんき	上半期
かみや	紙屋
かみよ	神世
かみよ	神代
かみん	仮眠
かみん	夏眠
かめ	亀
かめ	瓶
かめい	仮名
かめい	加盟
かめい	家名
かめん	仮面
がめん	画面
かも	鴨
かも	醸
かもい	鴨居
かもく	寡黙
かもく	科目
かもく	課目
かもしだ	醸し出
かもつ	貨物
かもつせん	貨物船
かもめ	鴎
かもん	家紋
かや	蚊帳
かや	茅
かや	萱
かや	榧
かやく	火薬
かゆ	粥
かゆ	痒
かよ	通
かよう	歌謡
かよう	火曜
かようきょく	歌謡曲
がようし	画用紙
かようせい	可溶性
かようび	火曜日
がよく	我欲
から	殻
から	空
から	枯ら
から	辛
から	絡
がら	柄
からかさ	傘
からかみ	唐紙
からくち	辛口
からし	芥子
からす	烏
からす	鴉
がらす	硝子
からだ	躯
からだ	身体
からだ	体
からたけわり	幹竹割り
からっかぜ	からっ風
からっぽ	空っぽ
からて	空手
からぶり	空振り
からま	絡ま
からまわり	空回り
からみ	空身
からみあ	絡み合
からみつ	絡み付
からめ	絡め
がらん	伽藍
がらんどう	伽藍堂
かり	仮
かり	雁
かり	借り
かり	狩
かり	狩り
かり	猟
かりあげ	刈り上げ
かりあげ	借り上げ
かりあつめ	かり集め
かりいれ	刈り入れ
かりいれ	借り入れ
かりいれ	借入れ
かりいれきん	借入金
かりうけ	借り受け
かりかた	借方
かりき	借り切
かりこ	刈り込
かりこ	借り越
かりしゃくほう	仮釈放
かりしょぶん	仮処分
かりずまい	仮住い
かりだ	駆り出
かりたて	駆り立て
かりちょういん	仮調印
かりて	借り手
かりと	刈り取
かりぬい	仮縫い
かりばらい	仮払
かりばらい	仮払い
かりばらいきん	仮払金
かりめんきょ	仮免許
かりゅう	下流
がりゅう	我流
かりょう	加療
かりょう	科料
がりょうてんせい	画竜点睛
がりょうてんせい	画龍点睛
かりょく	火力
かる	軽
かるがる	軽々
かるがるし	軽々し
かるはずみ	軽はずみ
かるわざ	軽業
かれ	枯れ
かれ	彼
かれ	涸れ
かれい	華麗
かれい	鰔
かれい	鰈
かれき	枯木
がれき	瓦礫
かれし	彼氏
かれつ	苛烈
かれは	枯れ葉
かれは	枯葉
かれら	彼ら
かれら	彼等
かれん	可憐
がろう	画廊
かろやか	軽やか
かわ	河
かわ	革
かわ	渇
かわ	乾
かわ	換わ
かわ	交わ
かわ	川
かわ	側
かわ	替
かわ	替わ
かわ	代
かわ	代わ
かわ	皮
かわ	変
かわ	変わ
がわ	側
かわい	可愛
かわいそう	可哀想
かわいそう	可哀相
かわか	乾か
かわかみ	川上
かわぐち	河口
かわぐち	川口
かわぐつ	革靴
かわざんよう	皮算用
かわしも	川下
かわず	蛙
かわせ	為替
かわぞこ	川底
かわばた	川端
かわや	厠
かわら	河原
かわら	瓦
かわら	川原
かわり	変わり
かん	冠
かん	寒
かん	勘
かん	姦
かん	完
かん	感
かん	棺
かん	管
かん	缶
かん	艦
かん	観
かん	間
かん	関
かん	館
かん	甲
かん	癇
がん	癌
がん	雁
がん	願
かんあん	勘案
かんい	簡易
がんい	含意
かんいっぱつ	間一髪
かんいん	姦淫
かんいん	館員
かんえん	肝炎
がんえん	岩塩
かんおけ	棺桶
かんか	感化
かんか	看過
がんか	眼下
がんか	眼科
かんかい	官界
かんかい	寛解
かんがい	寒害
かんがい	干害
かんがい	感慨
がんかい	眼科医
かんがえ	考え
かんがえかた	考え方
かんがえこ	考え込
かんがえだ	考え出
かんがえつ	考え付
かんがえつめ	考え詰め
かんがえなお	考え直
かんがえぬ	考え抜
かんかく	感覚
かんかく	間隔
かんがく	官学
かんかつ	管轄
かんがみ	鑑み
かんき	乾期
かんき	寒気
かんき	喚起
かんき	換気
かんき	歓喜
かんきせん	換気扇
かんきつ	柑橘
かんきゃく	観客
かんきゅう	緩急
がんきゅう	眼球
かんぎゅうじゅうとう	汗牛充棟
かんきょ	官許
かんきょ	閑居
かんきょう	感興
かんきょう	環境
かんぎょう	勧業
かんぎょう	官業
がんきょう	眼鏡
がんきょう	頑強
かんきん	換金
かんきん	監禁
がんきん	元金
かんく	管区
かんぐ	勘ぐ
かんぐ	勘繰
がんぐ	玩具
かんぐん	官軍
かんけい	関係
かんげい	歓迎
かんけいな	関係な
かんげき	感激
かんげき	観劇
かんげき	間隙
かんけつ	完結
かんけつ	簡潔
かんけつ	間欠
かんげん	換言
かんげん	甘言
かんげん	諌言
かんげん	還元
がんけん	頑健
かんげんがく	管弦楽
かんこ	歓呼
かんご	看護
がんこ	頑固
かんこう	刊行
かんこう	完工
かんこう	感光
かんこう	慣行
かんこう	敢行
かんこう	緩行
かんこう	観光
がんこう	眼光
かんこうきゃく	観光客
がんこうしゅてい	眼高手低
かんこうちょう	官公庁
かんこうへん	肝硬変
かんこうれい	箝口令
かんこく	勧告
かんごく	監獄
かんこつだったい	換骨奪胎
かんこどり	閑古鳥
かんごふ	看護婦
かんこんそうさい	冠婚葬祭
かんさ	監査
かんさ	鑑査
かんさい	完済
かんさい	簡裁
かんざい	管財
がんさく	贋作
かんさつ	監察
かんさつ	観察
かんさつ	鑑札
かんさん	換算
かんさん	閑散
かんざん	換算
かんし	監視
かんじ	幹事
かんじ	感じ
かんじ	換字
かんじ	漢字
かんじ	監事
かんしき	乾式
かんしき	鑑識
かんしつ	乾湿
がんじつ	元日
かんして	関して
かんじと	感じと
かんしゃ	官舎
かんしゃ	感謝
かんじゃ	患者
かんしゃく	癇癪
かんじゃく	閑寂
かんしゃくだま	かんしゃく玉
かんしゃくだま	癇癪玉
かんしゅ	看取
かんしゅ	看守
かんじゅ	甘受
かんしゅう	慣習
かんしゅう	監修
かんしゅう	観衆
がんしゅう	含羞
かんじゅく	完熟
かんじゅせい	感受性
かんしょ	甘薯
かんじょ	官女
かんじょ	寛恕
がんしょ	願書
かんしょう	干渉
かんしょう	感傷
かんしょう	環礁
かんしょう	緩衝
かんしょう	観賞
かんしょう	鑑賞
かんじょう	勘定
かんじょう	感情
かんじょう	環状
がんしょう	岩礁
がんじょう	頑丈
かんしょうてき	感傷的
かんしょく	感触
かんしょく	間食
かんしょく	閑職
がんしょく	顔色
かんしん	感心
かんしん	歓心
かんしん	関心
かんじん	肝心
かんじん	肝腎
かんしんじ	関心事
かんすい	冠水
かんすい	完遂
かんすい	潅水
かんすい	灌水
かんすう	関数
かんせい	乾性
かんせい	喚声
かんせい	完成
かんせい	官製
かんせい	感性
かんせい	慣性
かんせい	歓声
かんせい	管制
かんせい	閑静
かんぜい	関税
がんせき	岩石
かんせつ	間接
かんせつ	関節
かんせん	幹線
かんせん	感染
かんせん	汗腺
かんせん	艦船
かんせん	観戦
かんぜん	完全
かんぜん	敢然
かんそ	簡素
がんそ	元祖
かんそう	乾燥
かんそう	完走
かんそう	感想
かんそう	歓送
かんぞう	肝臓
かんそく	観測
かんそん	寒村
かんたい	寒帯
かんたい	歓待
かんたい	艦隊
かんだい	寛大
かんたく	干拓
かんたん	感嘆
かんたん	簡単
かんだん	寒暖
かんだん	歓談
かんだん	間断
がんたん	元旦
かんち	感知
かんち	関知
かんちがい	勘違い
がんちく	含蓄
かんちゅう	寒中
がんちゅう	眼中
かんちょう	官庁
かんちょう	干潮
かんちょう	管長
かんちょう	艦長
かんちょう	間諜
かんちょう	館長
かんちょう	浣腸
かんづ	勘づ
かんづ	勘付
かんづ	感づ
かんづ	感付
かんつう	貫通
かんづめ	缶詰
かんてい	官邸
かんてい	艦艇
かんてい	鑑定
かんてつ	貫徹
かんてん	観点
かんでん	感電
かんでんち	乾電池
かんど	感度
かんとう	巻頭
かんとう	敢闘
かんどう	勘当
かんどう	感動
かんどうし	感動詞
かんどうみゃく	冠動脈
かんとく	監督
かんな	鉋
かんない	管内
かんない	艦内
かんない	館内
かんなづき	神無月
かんにゅう	貫入
かんにん	堪忍
かんぬし	神主
かんねん	観念
がんねん	元年
かんのう	完納
かんのう	官能
かんのう	感応
かんのん	観音
かんば	悍馬
かんぱ	カンパ
かんぱ	寒波
がんば	頑張
かんばい	寒梅
かんばい	完売
かんぱい	乾杯
かんぱい	完敗
かんぱく	関白
かんばし	芳し
かんばつ	簡抜
かんばつ	間伐
かんばつ	旱魃
かんぱつ	煥発
かんばん	看板
かんぱん	乾パン
かんぱん	甲板
がんばん	岩盤
かんび	完備
がんぴし	雁皮紙
かんびょう	看病
かんぴょう	乾瓢
かんぴょう	干瓢
かんぶ	幹部
かんぶ	患部
かんぷ	乾布
かんぷ	完膚
かんぷ	還付
かんぷう	寒風
かんぷう	完封
かんぷく	感服
かんぶつ	乾物
かんぶん	漢文
かんぺき	完ぺき
かんぺき	完璧
がんぺき	岸壁
かんべつ	鑑別
かんべん	勘弁
かんべん	簡便
かんぼう	官房
かんぼう	感冒
かんぽう	官報
かんぽう	漢方
がんぼう	願望
かんぽうのまじわり	管鮑の交わり
かんぽうやく	漢方薬
かんぼく	潅木
かんぼつ	陥没
がんぽん	元本
かんまつ	巻末
かんまん	干満
かんまん	緩慢
かんみ	甘味
かんみん	官民
かんむり	冠
かんむりょう	感無量
かんめい	感銘
かんめい	簡明
がんめい	頑迷
がんめいころう	頑迷固陋
がんめん	顔面
がんもく	眼目
かんもん	喚問
かんもん	関門
かんやく	完訳
かんやく	監訳
かんやく	簡約
がんやく	丸薬
かんゆ	換喩
かんゆう	勧誘
がんゆう	含有
かんよ	関与
かんよう	寛容
かんよう	慣用
かんよう	肝要
かんようしょくぶつ	観葉植物
がんらい	元来
かんらく	歓楽
かんらく	陥落
かんらん	観覧
かんり	官吏
かんり	管理
がんり	元利
がんりき	眼力
かんりしゃ	管理者
かんりしょく	管理職
かんりにん	管理人
かんりゃく	簡略
かんりゃくか	簡略化
かんりゅう	寒流
かんりょう	完了
かんりょう	官僚
がんりょう	顔料
かんるい	感涙
かんれい	寒冷
かんれい	慣例
かんれき	還暦
かんれん	関連
かんろ	寒露
かんろ	甘露
がんろう	玩弄
かんろく	貫禄
かんろに	甘露煮
かんわ	漢和
かんわ	緩和
かんわきゅうだい	閑話休題
き	黄
き	器
き	基
き	奇
き	忌
き	期
き	機
き	帰
き	気
き	季
き	記
き	効
き	斬
き	樹
き	訊
き	切
き	着
き	聴
き	伐
き	聞
き	木
き	利
ぎ	儀
ぎ	擬
ぎ	義
ぎ	議
ぎ	切
きあい	気合い
ぎあく	偽悪
きあつ	気圧
きあん	起案
ぎあん	議案
きい	奇異
きい	貴意
きいと	生糸
きいろ	黄色
きいん	起因
ぎいん	議員
ぎいん	議院
きう	気宇
きうん	機運
きうん	気運
きえ	帰依
きえ	消え
きえい	機影
きえい	気鋭
きえい	消え入
きえさ	消え去
きえん	気炎
ぎえんきん	義援金
きお	気負
きおいた	気負い立
きおう	既往
きおうしょう	既往症
きおく	記憶
きおくれ	気遅れ
きおち	気落ち
きおん	気温
ぎおん	擬音
きか	幾何
きか	帰化
きか	気化
きか	貴下
きが	飢餓
きかい	器械
きかい	奇怪
きかい	機会
きかい	機械
きがい	危害
きがい	気概
ぎかい	議会
きかいか	機械化
きがえ	着替え
きかがく	幾何学
きがかり	気がかり
きかく	企画
きかく	規格
きがく	器楽
きかざ	着飾
きがね	気兼ね
きがまえ	気構え
きがる	気軽
きかん	器官
きかん	基幹
きかん	既刊
きかん	期間
きかん	機関
きかん	帰還
きかん	気管
きかん	季刊
きかん	貴簡
きがん	祈願
ぎかん	技官
きかんし	気管支
きかんしえん	気管支炎
きかんしゃ	機関車
きき	危機
きき	機器
きき	効き
ぎぎ	疑義
ききい	聴き入
ききい	聞き入
ききいっぱつ	危機一髪
ききいれ	聞き入れ
ききかえ	聞き返
ききぐるし	聞き苦し
ききこ	聴き込
ききこ	聞き込
ききだ	聞き出
ききて	聞き手
ききと	聞き取
ききなが	聞き流
ききめ	効き目
ききゃく	棄却
ききゅう	希求
ききゅう	気球
ききょ	起居
ききょう	奇矯
ききょう	帰京
ききょう	帰郷
ききょう	桔梗
きぎょう	企業
きぎょう	起業
きぎょうか	起業家
ぎきょうしん	義侠心
きぎょうたい	企業体
ぎきょく	戯曲
ききわけ	聞き分け
ききん	基金
ききん	寄金
ききんぞく	貴金属
きく	規矩
きく	掬
きく	菊
きく	鞠
きぐ	危惧
きぐ	器具
きぐ	機具
きぐう	奇遇
きくばり	気くばり
きくばり	気配り
きくみ	菊見
きぐらい	気位
きぐろう	気苦労
きくん	貴君
きけい	奇形
きけい	貴兄
きげき	喜劇
きけつ	既決
きけつ	帰結
ぎけつ	議決
きけん	危険
きけん	棄権
きけん	気圏
きげん	期限
きげん	機嫌
きげん	紀元
きげん	起源
きげんぜん	紀元前
きこ	着込
きご	季語
きこう	奇行
きこう	寄港
きこう	寄稿
きこう	機構
きこう	帰港
きこう	気候
きこう	気功
きこう	気孔
きこう	稀覯
きこう	紀行
きこう	貴校
きこう	起工
きごう	揮毫
きごう	記号
ぎこう	技巧
きこうし	貴公子
きこうぼん	稀覯本
きこえ	聞こえ
きこえよがし	聞こえよがし
きこく	帰国
きこく	貴国
ぎごく	疑獄
きごころ	気心
きこしめ	聞こし召
きこつ	気骨
きこな	着こな
きこん	既婚
きざ	気障
きざ	刻
きざ	兆
きざ	萌
きさい	奇才
きさい	既済
きさい	記載
きさい	起債
きさい	鬼才
きざい	機材
きさき	后
きさき	妃
きさく	気さく
ぎさく	偽作
きさま	貴様
きざみ	刻
きざみこ	刻み込
きざみつけ	刻みつけ
きさらぎ	如月
きさん	帰参
きさん	起算
きし	岸
きし	棋士
きし	貴誌
きし	騎士
きし	軋
きじ	記事
きじ	生地
きじ	木地
きじ	雉
ぎし	技士
ぎし	技師
ぎし	義肢
ぎじ	疑似
ぎじ	議事
きしかいせい	起死回生
ぎしき	儀式
きじく	基軸
きじく	機軸
きしつ	気質
きじつ	期日
ぎじどう	議事堂
きじばと	雉鳩
きしべ	岸辺
きしゃ	帰社
きしゃ	汽車
きしゃ	記者
きしゃ	貴社
きしゃく	希釈
きしゅ	奇手
きしゅ	旗手
きしゅ	期首
きしゅ	機種
きしゅ	機首
きしゅ	騎手
きじゅ	喜寿
ぎしゅ	義手
きしゅう	奇襲
きじゅう	機銃
きじゅうき	起重機
きしゅく	寄宿
きしゅつ	既出
きじゅつ	奇術
きじゅつ	記述
ぎじゅつ	技術
きじゅん	基準
きじゅん	規準
きしょ	期初
きしょ	貴書
きじょ	貴女
ぎしょ	偽書
きしょう	希少
きしょう	気象
きしょう	気性
きしょう	稀少
きしょう	記章
きしょう	起床
きじょう	机上
きじょう	機上
きじょう	気丈
きじょう	軌条
きじょう	騎乗
ぎしょう	偽称
ぎしょう	偽証
ぎじょう	議場
きしょうだい	気象台
きしょうてんけつ	起承転結
きしょく	気色
ぎじろく	議事録
きしん	寄進
きしん	貴信
きじん	奇人
ぎしん	疑心
ぎじん	擬人
ぎしんあんき	疑心暗鬼
きす	鱚
きず	傷
きず	築
きず	瑕
きずあと	傷跡
きすい	既遂
きすう	奇数
きすう	帰趨
きずきあげ	築き上げ
きずぐち	傷口
きずつ	傷つ
きずつけ	傷つけ
きずな	絆
きせ	着せ
きせい	奇声
きせい	寄生
きせい	既成
きせい	既製
きせい	帰省
きせい	気勢
きせい	規制
きせい	規正
ぎせい	犠牲
きせき	奇跡
きせき	軌跡
ぎせき	議席
きせつ	既設
きせつ	季節
きぜつ	気絶
きせん	基線
きせん	汽船
きぜん	毅然
ぎぜん	偽善
きそ	基礎
きそ	起訴
きそ	競
きそう	寄贈
きそう	起草
きぞう	寄贈
ぎそう	偽装
ぎそう	擬装
ぎそう	艤装
ぎぞう	偽造
きそうてんがい	奇想天外
きそく	気息
きそく	規則
きぞく	帰属
きぞく	貴族
ぎそく	義足
ぎぞく	義賊
きそん	既存
きそん	毀損
きぞん	既存
きた	北
きた	来
きた	来た
きたい	危殆
きたい	奇体
きたい	奇態
きたい	期待
きたい	機体
きたい	気体
きたい	稀代
きだい	貴台
ぎだい	議題
きたいち	期待値
きたえ	鍛え
きたえあげ	鍛え上げ
きたかぜ	北風
きたがわ	北側
きたく	寄託
きたく	帰宅
きたぐち	北口
きたけ	着丈
きだて	気だて
きたな	汚
きたならし	汚らし
きたはんきゅう	北半球
きたまわり	北回り
きたる	来る
きたん	忌憚
きだん	気団
きち	基地
きち	既知
きち	機知
きち	貴地
きち	吉
きちがい	気違い
きちじ	吉事
きちじつ	吉日
きちゃく	帰着
きちゅう	忌中
きちょう	基調
きちょう	機長
きちょう	記帳
きちょう	貴重
ぎちょう	議長
きちょうめん	几帳面
きっ	喫
きづ	気づ
きづ	気付
きつえん	喫煙
きづか	気遣
きっかけ	切っ掛け
きづかれ	気疲れ
きっきょう	吉凶
きっく	キック
きつけ	着付け
きづけ	気付
きっこう	亀甲
きっさ	喫茶
きっさき	切先
きっさてん	喫茶店
ぎっしゃ	牛車
きっすい	喫水
きっすい	生粋
きっせき	詰責
きづち	木槌
きっちょう	吉兆
きつつき	啄木鳥
きって	切手
きつね	狐
きっぷ	気っ風
きっぷ	切符
きっぽう	吉報
きつもん	詰問
きてい	基底
きてい	既定
きてい	規定
きてい	規程
ぎてい	議定
きていち	既定値
きてき	汽笛
きてん	基点
きてん	機転
きてん	貴店
きてん	起点
きでん	貴殿
きと	企図
きと	帰途
きど	気ど
きど	気取
きど	輝度
きど	木戸
きとう	帰投
きとう	祈祷
きどう	機動
きどう	起動
きどう	軌道
きどうたい	機動隊
きとく	危篤
きとく	奇特
きとく	既得
きどるい	希土類
きない	機内
きなが	気長
きなさ	来なさ
きにい	気に入
きにち	忌日
きにゅう	記入
きにん	帰任
きぬ	衣
きぬ	絹
きぬいと	絹糸
きぬがさ	衣笠
きぬた	砧
きね	杵
きねん	祈念
きねん	記念
ぎねん	疑念
きねんひ	記念碑
きねんび	記念日
きねんひん	記念品
きのう	機能
きのう	帰納
きのう	昨日
ぎのう	技能
きのえ	甲
きのこ	茸
きのと	乙
きのどく	気の毒
きのり	気乗り
きば	黄ば
きば	牙
きば	気張
きば	騎馬
きば	木場
きはく	希薄
きはく	気迫
きばく	起爆
きはじめ	来はじめ
きはじめ	来始め
きはずかし	気恥ずかし
きはだ	木肌
きばたらき	気ばたらき
きはつ	揮発
きばつ	奇抜
きはつゆ	揮発油
きばらし	気晴らし
きはん	規範
きばん	基盤
きひ	忌避
きび	機微
きび	黍
きびき	忌引
きびし	厳し
きびす	踵
きびたき	黄鶲
きひつ	起筆
きひょう	起票
きびょう	奇病
きひん	気品
きひん	貴賓
きびん	機敏
きふ	寄付
ぎふ	義父
きふう	気風
きふく	起伏
きぶくれ	着膨れ
きぶっせい	気ぶっせい
きぶとり	着太り
きぶん	気分
ぎふん	義憤
きへい	騎兵
きべん	詭弁
ぎへんすう	疑変数
きぼ	規模
ぎぼ	義母
きほう	記法
きほう	貴方
きぼう	希望
ぎほう	技法
きぼね	気骨
きぼり	木彫り
きほん	基本
きま	極
きま	決
きま	決ま
きまえ	気前
きまぐれ	気まぐれ
きまず	気まず
きまつ	期末
きまって	決って
きまま	気まま
ぎまん	欺瞞
きみ	黄身
きみ	気味
きみ	君
ぎみ	気味
きみがわる	気味が悪
きみじか	気短
きみたち	君達
きみつ	機密
きみどり	黄緑
きみょう	奇妙
ぎむ	義務
きむずかし	気難し
きむづかし	気難し
ぎむづけ	義務づけ
きめ	決め
きめ	肌理
きめ	木目
きめい	記名
ぎめい	偽名
きめこ	決め込
きめこまか	きめ細か
きめつけ	決めつけ
きめて	決め手
きも	肝
きもち	気持
きもち	気持ち
きもったま	肝っ玉
きもの	着物
きもん	鬼門
ぎもん	疑問
ぎもんし	疑問視
きゃく	客
きやく	規約
ぎゃく	逆
きゃくあし	客足
きゃくいん	客員
きゃくいん	脚韻
きゃくえん	客演
ぎゃくさつ	虐殺
ぎゃくさん	逆算
きゃくし	客死
きゃくしつ	客室
きゃくしゃ	客車
ぎゃくしゅう	逆襲
ぎゃくじゅん	逆順
ぎゃくじょう	逆上
きゃくしょく	脚色
きゃくじん	客人
ぎゃくすう	逆数
きゃくせき	客席
ぎゃくせつ	逆接
ぎゃくせつ	逆説
きゃくせん	客船
きゃくせん	脚線
ぎゃくたい	虐待
きゃくちゅう	脚注
ぎゃくてん	逆転
きゃくど	客土
ぎゃくふう	逆風
きゃくほん	脚本
きゃくま	客間
ぎゃくもどり	逆戻り
ぎゃくよう	逆用
ぎゃくり	逆理
ぎゃくりゅう	逆流
きゃしゃ	華奢
きやす	気安
きやすめ	気休め
きやせ	着痩せ
きゃたつ	脚立
きゃっか	却下
きゃっかん	客観
ぎゃっきょう	逆境
きゃっこう	脚光
ぎゃっこう	逆行
きゅう	仇
きゅう	休
きゅう	急
きゅう	灸
きゅう	球
きゅう	窮
きゅう	級
きゅう	給
きゅう	旧
きゅう	九
きゆう	杞憂
ぎゅう	牛
きゅうあい	求愛
きゅういん	吸引
きゅうえん	休演
きゅうえん	救援
きゅうか	休暇
きゅうか	旧家
きゅうかい	休会
きゅうかく	球殻
きゅうがく	休学
きゅうかな	旧カナ
きゅうかな	旧仮名
きゅうかん	休刊
きゅうかん	休閑
きゅうかん	休館
きゅうかん	急患
きゅうかん	旧館
きゅうかんちょう	九官鳥
きゅうき	吸気
きゅうぎ	球技
きゅうきゅう	救急
きゅうきゅう	汲々
きゅうきゅうしゃ	救急車
きゅうきょ	急きょ
きゅうきょ	急遽
きゅうぎょう	休業
きゅうきょく	究極
きゅうきん	給金
きゅうくつ	窮屈
きゅうけい	休憩
きゅうけい	急啓
きゅうけい	求刑
きゅうけい	球形
きゅうげき	急激
きゅうけつ	吸血
きゅうけつき	吸血鬼
きゅうげん	急減
きゅうご	救護
ぎゅうご	牛後
きゅうこう	休校
きゅうこう	休耕
きゅうこう	休講
きゅうこう	急行
きゅうごう	糾合
きゅうごう	鳩合
きゅうこうか	急降下
きゅうこく	急告
きゅうこん	求婚
きゅうこん	球根
きゅうさい	休載
きゅうさい	救済
きゅうし	臼歯
きゅうし	休止
きゅうし	急死
きゅうじ	給仕
きゅうしき	旧式
きゅうじつ	休日
きゅうしふ	休止符
きゅうしゃ	厩舎
きゅうしゅう	吸収
きゅうしゅつ	救出
きゅうしゅん	急峻
きゅうしょ	急所
きゅうじょ	救助
きゅうじょう	休場
きゅうじょう	宮城
きゅうじょう	球場
きゅうじょう	球状
きゅうじょう	窮状
きゅうじょうしょう	急上昇
きゅうしょく	休職
きゅうしょく	求職
きゅうしょく	給食
きゅうじょたい	救助隊
きゅうしん	休診
きゅうしん	急進
きゅうじん	求人
きゅうす	急須
きゅうすい	吸水
きゅうすい	給水
きゅうすう	級数
きゅうせい	急性
きゅうせい	急逝
きゅうせい	旧制
きゅうせい	旧姓
きゅうせいしゅ	救世主
きゅうせいちょう	急成長
きゅうせき	求積
きゅうせき	旧跡
きゅうせん	休戦
きゅうせんぽう	急先鋒
きゅうそう	急送
きゅうぞう	急増
きゅうそく	休息
きゅうそく	急速
きゅうたい	球体
きゅうたい	旧態
きゅうだい	及第
きゅうだん	球団
きゅうだん	糾弾
きゅうだん	給弾
きゅうち	窮地
きゅうち	旧知
きゅうちゃく	吸着
きゅうちゅう	宮中
きゅうちょう	級長
きゅうてい	宮廷
きゅうていしゃ	急停車
きゅうてん	急転
きゅうでん	宮殿
きゅうでん	給電
きゅうとう	急騰
きゅうとう	給湯
きゅうどう	弓道
きゅうどう	旧道
ぎゅうにく	牛肉
きゅうにゅう	吸入
ぎゅうにゅう	牛乳
きゅうねつ	急熱
きゅうねん	旧年
きゅうは	急派
きゅうば	急場
ぎゅうば	牛馬
きゅうはく	急迫
きゅうはく	窮迫
きゅうはん	旧版
きゅうばん	吸盤
きゅうびょう	急病
きゅうふ	給付
きゅうふきん	給付金
きゅうへん	急変
きゅうぼ	急募
ぎゅうほ	牛歩
きゅうほう	急報
きゅうぼう	窮乏
きゅうみん	休眠
きゅうむ	急務
きゅうめい	救命
きゅうめい	究明
きゅうめい	糾明
きゅうめん	球面
きゅうゆ	給油
きゅうゆう	級友
きゅうゆう	旧友
きゅうよ	給与
きゅうよう	休養
きゅうよう	急用
きゅうらい	旧来
きゅうらく	急落
きゅうり	胡瓜
きゅうりゅう	急流
きゅうりょう	丘陵
きゅうりょう	給料
きゅうりょうび	給料日
きゅうれい	急冷
きゅうれき	旧暦
きょ	居
きょ	挙
きょ	虚
きよ	寄与
きよ	清
ぎょ	御
ぎょい	御意
きょう	京
きょう	供
きょう	凶
きょう	卿
きょう	境
きょう	強
きょう	狂
きょう	興
きょう	饗
きょう	経
きょう	今日
きよう	器用
きよう	起用
ぎょう	行
きょうあい	狭隘
きょうい	強意
きょうい	胸囲
きょうい	脅威
きょうい	驚異
きょういく	教育
きょういん	教員
きょうえい	競泳
きょうえい	共栄
きょうえき	共益
きょうえつ	恐悦
きょうえん	競演
きょうえん	共演
きょうえん	饗宴
きょうおう	供応
きょうか	強化
きょうか	教化
きょうか	教科
きょうが	恭賀
きょうかい	協会
きょうかい	境界
きょうかい	教会
きょうかい	教誨
きょうがい	境涯
ぎょうかい	業界
きょうかく	侠客
きょうかく	胸郭
きょうがく	共学
きょうがく	驚愕
ぎょうかく	仰角
ぎょうかく	行革
きょうかしょ	教科書
きょうかつ	恐喝
きょうかん	共感
きょうかん	教官
ぎょうかん	行間
きょうき	侠気
きょうき	凶器
きょうき	狂喜
きょうき	狂気
きょうき	驚喜
きょうぎ	競技
きょうぎ	協議
きょうぎ	教義
きょうぎ	狭義
きょうぎ	経木
ぎょうぎ	行儀
きょうきゃく	橋脚
きょうきゅう	供給
きょうぎょう	協業
ぎょうぎょうし	仰々し
きょうきん	胸襟
きょうぐう	境遇
きょうくん	教訓
きょうげき	京劇
きょうげき	挟撃
きょうけつ	供血
ぎょうけつ	凝結
ぎょうけつ	凝血
きょうけん	強健
きょうけん	強権
きょうげん	狂言
きょうけんびょう	狂犬病
きょうこ	強固
きょうご	教護
ぎょうこ	凝固
きょうこう	凶行
きょうこう	強硬
きょうこう	強行
きょうこう	恐慌
きょうごう	競合
きょうごう	強豪
きょうこうぐん	強行軍
きょうこく	峡谷
きょうこく	強国
きょうこつ	胸骨
きょうさ	教唆
ぎょうざ	餃子
きょうさい	共催
きょうさい	共済
きょうさい	恐妻
きょうざい	教材
きょうさく	競作
きょうさく	凶作
きょうざつ	夾雑
きょうざめ	興ざめ
きょうさん	共産
きょうさん	協賛
きょうし	教師
きょうじ	共時
きょうじ	凶事
きょうじ	教示
きょうじ	矜持
ぎょうし	凝視
ぎょうじ	行司
ぎょうじ	行事
きょうしき	胸式
きょうしつ	教室
きょうしゃ	強者
ぎょうしゃ	業者
きょうじゃく	強弱
きょうじゅ	享受
きょうじゅ	教授
ぎょうしゅ	業種
きょうしゅう	強襲
きょうしゅう	郷愁
ぎょうしゅう	凝集
きょうしゅうじょ	教習所
きょうしゅく	恐縮
ぎょうしゅく	凝縮
きょうしゅつ	供出
きょうじゅつ	供述
きょうじゅん	恭順
きょうしょ	教書
ぎょうしょ	行書
きょうしょう	狭小
きょうじょう	教場
きょうじょう	教条
ぎょうしょう	行商
きょうしょく	教職
きょうしん	共振
きょうしん	強心
きょうしん	強震
きょうじん	強靭
きょうじん	狂人
きょうしんしょう	狭心症
ぎょうずい	行水
きょうせい	共棲
きょうせい	共生
きょうせい	強制
きょうせい	強請
きょうせい	教生
きょうせい	矯正
ぎょうせい	行政
ぎょうせき	業績
きょうそ	教祖
きょうそう	競争
きょうそう	競走
きょうそう	強壮
きょうぞう	胸像
きょうぞう	鏡像
ぎょうそう	形相
きょうそうきょく	協奏曲
きょうそく	教則
きょうぞめ	京染
きょうそん	共存
きょうぞん	共存
きょうだ	強打
きょうだ	怯懦
きょうたい	狂態
きょうだい	強大
きょうだい	橋台
きょうだい	鏡台
きょうだい	兄弟
ぎょうたい	業態
きょうたく	供託
きょうたん	驚嘆
きょうだん	凶弾
きょうだん	教団
きょうだん	教壇
きょうち	境地
きょうちゅう	胸中
きょうちょ	共著
きょうちょう	凶兆
きょうちょう	協調
きょうちょう	強調
きょうつう	共通
きょうてい	競艇
きょうてい	協定
きょうてい	教程
きょうてき	強敵
きょうてん	経典
ぎょうてん	仰天
きょうてんどうち	驚天動地
きょうと	教徒
きょうど	強度
きょうど	郷土
きょうとう	共闘
きょうとう	教頭
きょうとう	驚倒
きょうどう	共同
きょうどう	協同
きょうどう	経堂
ぎょうとう	行頭
きょうどうたい	共同体
きょうとうほ	橋頭堡
きょうねん	享年
きょうばい	競売
きょうはく	強迫
きょうはく	脅迫
きょうはん	共犯
きょうび	今日日
きょうふ	恐怖
きょうぶ	胸部
きょうふう	強風
きょうぶんさん	共分散
きょうべん	強弁
きょうべん	教鞭
きょうほ	競歩
きょうぼう	共謀
きょうぼう	凶暴
きょうぼう	狂暴
きょうぼく	喬木
きょうほん	狂奔
きょうま	京間
ぎょうまつ	行末
きょうみ	興味
きょうむ	教務
ぎょうむ	業務
きょうめい	共鳴
きょうめい	響鳴
きょうめん	鏡面
きょうやく	協約
きょうゆ	教諭
きょうゆう	享有
きょうゆう	共有
きょうゆう	梟雄
きょうよ	供与
きょうよう	共用
きょうよう	強要
きょうよう	教養
きょうらく	享楽
きょうらん	供覧
きょうらん	狂乱
きょうり	郷里
きょうりつ	共立
きょうりゅう	恐竜
きょうりょう	橋梁
きょうりょう	狭量
きょうりょく	協力
きょうりょく	強力
きょうれい	強冷
きょうれつ	強烈
ぎょうれつ	行列
きょうれん	教練
きょうわ	共和
きょうわ	協和
きょうわこく	共和国
きょうわせい	共和制
きょえい	虚栄
ぎょえい	魚影
きょか	許可
ぎょかい	魚介
きょがく	巨額
ぎょがん	魚眼
きょぎ	虚偽
きょぎょう	虚業
ぎょきょう	漁協
ぎょぎょう	漁業
きょきょじつじつ	虚々実々
きょく	局
きょく	曲
きょく	極
ぎょく	玉
ぎょぐ	漁具
きょくいん	局員
きょくぎ	曲技
きょくげい	曲芸
きょくげん	局限
きょくげん	極言
きょくげん	極限
ぎょくざ	玉座
きょくざい	局在
ぎょくさい	玉砕
きょくしょ	局所
きょくしょう	極小
きょくしょう	極少
きょくしょかい	局所解
きょくせい	極性
ぎょくせきこんこう	玉石混淆
きょくせつ	曲折
きょくせん	曲線
きょくだい	極大
きょくたん	極端
きょくち	局地
きょくち	極地
きょくち	極致
きょくちょう	局長
きょくちょう	曲調
きょくてん	極点
きょくど	極度
きょくとう	極東
きょくどめ	局留
きょくどめ	局留め
きょくない	局内
きょくばん	局番
きょくぶ	局部
きょくめん	局面
きょくめん	曲面
きょくもく	曲目
きょくりつ	曲率
きょくりょく	極力
きょくろん	極論
ぎょぐん	魚群
きょげん	虚言
きょこう	挙行
きょこう	虚構
きょごう	倨傲
ぎょこう	漁港
きょこん	虚根
きょこん	許婚
きょし	挙止
ぎょじ	御璽
きょしき	挙式
きょしつ	居室
きょじつ	虚実
きょしてき	巨視的
きょじゃく	虚弱
きょしゅ	挙手
きょしゅう	去就
きょじゅう	居住
きょしゅつ	拠出
きょしゅつ	醵出
きょしょ	居所
きょしょう	巨匠
きょしょう	裾礁
ぎょしょう	漁礁
ぎょじょう	漁場
きょしょく	虚飾
きょしょくしょう	拒食症
きょしん	虚心
きょじん	巨人
きょしんたんかい	虚心坦懐
きょすう	虚数
きょせい	去勢
きょせい	巨星
きょせい	虚勢
きょぜつ	拒絶
ぎょせん	漁船
きょぞう	巨象
きょぞう	虚像
ぎょそん	漁村
きょだい	巨大
きょたく	居宅
きょだく	許諾
きょだつ	虚脱
きょっかい	曲解
きょっけい	極刑
きょてん	拠点
きょとう	巨頭
きょとう	挙党
きょどう	挙動
ぎょにく	魚肉
きょにんか	許認可
きょねん	去年
きょひ	巨費
きょひ	拒否
きょふ	巨富
ぎょふ	漁夫
ぎょぶつ	御物
きょほう	巨峰
きょほう	虚報
ぎょみん	漁民
きょむ	虚無
きよめ	清め
ぎょめい	御名
きょよう	許容
きょらい	去来
ぎょらい	魚雷
きよらか	清らか
きょり	巨利
きょり	距離
きょりゅう	居留
ぎょりん	魚鱗
ぎょるい	魚類
きょれい	虚礼
ぎょろう	漁撈
きよわ	気弱
きら	嫌
きら	切ら
きらい	帰来
きらい	嫌い
きらく	気楽
きらめ	燐
きらめ	煌
きり	桐
きり	切り
きり	霧
ぎり	義理
ぎり	切り
きりあげ	切り上げ
きりあげ	切上げ
きりおと	切り落と
きりかえ	切り替え
きりかえ	切替
きりかえ	切替え
きりかぶ	切株
きりかわ	切り替わ
きりきざ	切り刻
きりきず	切傷
きりくず	切り崩
きりくち	切口
きりこ	切り込
きりさげ	切り下げ
きりさげ	切下げ
きりさめ	霧雨
きりすて	切り捨て
きりすて	切捨て
きりた	切り立
きりだ	切り出
きりたんぽ	切りたんぽ
きりつ	規律
きりつ	起立
きりつめ	切り詰め
きりと	切り取
きりとり	切り取り
きりとり	切取り
きりぬ	切りぬ
きりぬ	切り抜
きりぬき	切抜き
きりはな	切り放
きりはな	切り離
きりはり	切り貼り
きりひら	切り開
きりふだ	切札
きりまわ	切り回
きりもり	切盛り
きりゅう	気流
きりょう	器量
ぎりょう	技量
ぎりょう	技倆
ぎりょう	議了
きりょく	気力
きりわけ	切り分け
きりん	麒麟
きれい	奇麗
きれい	綺麗
ぎれい	儀礼
きれぎれ	切れ切れ
きれこ	切れ込
きれつ	き裂
きれつ	亀裂
きれはし	切れ端
きれま	切れ間
きれめ	切れ目
きろ	岐路
きろ	帰路
きろく	記録
ぎろん	議論
きわ	際
ぎわく	疑惑
きわだ	際だ
きわま	窮ま
きわま	極ま
きわみ	極み
きわめ	究め
きわめ	極め
きわめつき	極めつき
きわめつく	窮め尽く
きわめて	極めて
きん	禁
きん	菌
きん	金
ぎん	吟
ぎん	銀
きんいつ	均一
きんいろ	金色
ぎんいろ	銀色
きんいん	近因
きんえい	近影
ぎんえい	吟詠
きんえん	禁煙
きんか	近火
きんか	金貨
きんが	謹賀
ぎんか	銀貨
ぎんが	銀河
きんかい	近海
きんかい	金塊
きんがく	金額
きんかん	近刊
きんかん	金冠
きんがん	近眼
きんき	欣喜
きんきゅう	緊急
きんぎょ	金魚
きんきょう	近況
きんきょり	近距離
きんきん	近々
きんぎん	金銀
きんく	禁句
きんけい	謹啓
きんけい	近景
きんけん	近県
きんけん	金券
きんけん	金権
きんげん	謹厳
きんこ	禁固
きんこ	金庫
きんこう	均衡
きんこう	近郊
きんこう	金工
きんこう	金鉱
ぎんこう	銀行
きんこつ	筋骨
きんこんしき	金婚式
ぎんこんしき	銀婚式
きんさ	僅差
ぎんざ	銀座
きんざい	近在
きんさく	近作
きんさく	金策
ぎんざん	銀山
きんし	禁止
きんし	近視
きんじ	禁じ
きんじ	近似
きんじち	近似値
きんしつ	均質
きんじつ	近日
きんじとう	金字塔
きんしゅ	禁酒
きんしゅ	金種
きんしゅく	緊縮
きんじょ	近所
きんしょう	僅少
きんしょう	金賞
ぎんしょう	吟唱
ぎんしょう	銀賞
ぎんじょう	吟醸
きんじょうとうち	金城湯池
きんしん	謹慎
きんしん	近親
きんせい	均整
きんせい	禁制
きんせい	謹製
きんせい	近世
きんせい	金星
ぎんせい	銀製
きんせつ	近接
きんせん	金銭
きんぜん	欣然
きんせんか	金盞花
きんそく	禁足
きんぞく	勤続
きんぞく	金属
きんそくれい	禁足令
きんたい	勤怠
きんだい	近代
きんだん	禁断
きんちさん	禁治産
きんちゃく	近着
きんちょ	近著
きんちょう	緊張
きんちょう	金打
きんてい	欽定
きんてい	謹呈
きんとう	均等
きんにく	筋肉
きんにくつう	筋肉痛
きんねん	近年
きんぱく	緊迫
きんぱく	金箔
ぎんぱく	銀箔
きんぱつ	金髪
ぎんぱつ	銀髪
ぎんばん	銀盤
きんぴん	金品
きんぶん	均分
きんべん	勤勉
きんぺん	近辺
きんぼう	近傍
きんぼし	金星
ぎんまく	銀幕
ぎんみ	吟味
きんみつ	緊密
きんみゃく	金脈
きんむ	勤務
きんむさき	勤務先
きんもつ	禁物
きんゆ	禁輸
きんゆう	金融
きんゆうぎょう	金融業
きんよう	金曜
きんようび	金曜日
きんよく	禁欲
きんよく	金欲
きんらい	近来
きんり	金利
きんりょう	禁漁
きんりょう	禁猟
きんりょく	筋力
きんりょく	金力
きんりん	近隣
きんろう	勤労
く	汲
く	九
く	句
く	区
く	苦
く	喰
く	繰
く	酌
く	食
く	組
ぐ	具
ぐ	愚
ぐあい	具合
ぐあい	具合い
くい	悔い
くい	杭
くいあ	食い合
くいい	食い入
くいいじ	食い意地
くいき	区域
くいこ	食い込
くいさが	食い下が
くいちが	食い違
くいつ	食いつ
くいとめ	食い止め
くう	空
ぐう	寓
ぐう	遇
くうい	空位
くういき	空域
ぐういん	偶因
くうかん	空間
くうき	空気
くうきょ	空虚
くうぐん	空軍
くうこう	空孔
くうこう	空港
くうじ	空自
ぐうじ	宮司
くうしゃ	空車
くうしゅう	空襲
ぐうすう	偶数
くうせき	空席
くうぜん	空前
ぐうぜん	偶然
くうそ	空疎
くうそう	空想
ぐうぞう	偶像
くうちゅう	空中
くうちょう	空調
くうてん	空転
くうどう	空洞
くうはく	空白
ぐうはつ	偶発
くうふく	空腹
くうぼ	空母
くうほう	空砲
くうゆ	空輸
くうらん	空欄
くうれい	空冷
くうろ	空路
くうろん	空論
くえい	区営
くおん	久遠
くかく	区画
くがく	苦学
くかん	区間
くき	茎
くぎ	区切
くぎ	釘
くぎづけ	釘付け
ぐきょ	愚挙
くきょう	苦境
くぎょう	苦行
くぎょう	公卿
くぎり	句切り
くぎり	区切り
くく	括
くぐ	潜
くぐい	鵠
くけい	矩形
くげん	苦言
ぐこう	愚考
くさ	臭
くさ	草
くさ	腐
くさかり	草刈り
くさき	草木
くさばな	草花
くさむら	叢
くさもち	草餅
くさり	鎖
くさわけ	草分け
くし	駆使
くし	串
くし	櫛
くしくも	奇しくも
くじびき	くじ引き
ぐしゃ	愚者
くじゃく	孔雀
くしゅう	句集
くじゅう	苦渋
くじょ	駆除
くしょう	苦笑
くじょう	苦情
ぐしょう	具象
くじら	鯨
くじら	鯀
くじらじゃく	鯨尺
くしん	苦心
ぐしん	具申
くす	樟
くす	楠
くず	葛
くず	屑
くず	崩
ぐず	愚図
くずてつ	屑鉄
くずもち	葛餅
くすり	薬
くすりゆび	薬指
くずれ	崩れ
くずれおち	崩れ落ち
くずれさ	崩れ去
くせ	癖
ぐせい	愚生
くせつ	苦節
くせもの	曲者
くせん	苦戦
くそ	糞
くだ	下
くだ	管
くだ	降
くだ	砕
ぐたい	具体
ぐたいか	具体化
ぐたいてき	具体的
ぐたいれい	具体例
くだけ	砕け
くださ	下さ
くだもの	果物
くだらな	下らな
くだん	件
くち	朽ち
くち	口
ぐち	愚痴
くちあたり	口当り
くちえ	口絵
くちかず	口数
くちがね	口金
くちく	駆逐
くちぐせ	口ぐせ
くちぐせ	口癖
くちぐるま	口車
くちさがな	口さがな
くちすう	口数
くちずさ	口ずさ
くちづけ	口づけ
くちばし	口走
くちばし	喙
くちばし	嘴
くちはばった	口はばった
くちび	口火
くちびる	唇
くちべに	口紅
くちもと	口元
くちゅう	苦衷
くちゅう	駆虫
くちょう	区長
くちょう	口調
ぐちょく	愚直
くつ	靴
ぐつ	靴
くつう	苦痛
くつがえ	覆
くっきょう	屈強
くっきょく	屈曲
くっさく	掘削
くっし	屈指
くつした	靴下
くつじゅう	屈従
くつじょく	屈辱
くっしん	屈伸
くっせい	屈性
くっせつ	屈折
くったく	屈託
くつばこ	靴箱
くっぷく	屈伏
くっぷく	屈服
くつろ	寛
くつわ	轡
くてん	句点
くど	口説
くとう	苦闘
くどう	駆動
ぐとう	愚答
くとうてん	句読点
ぐどん	愚鈍
くない	区内
くなん	苦難
くに	国
くにがら	国柄
くにく	苦肉
くにぐに	国々
くのう	苦悩
くば	配
くび	頚
くび	首
くび	馘首
ぐび	具備
くびすじ	首筋
くびったけ	首ったけ
くびっぴき	首っ引き
くびわ	首輪
くふう	工夫
くぶくりん	九分九厘
くぶん	区分
くべつ	区別
くぼ	窪
くま	熊
ぐまい	愚昧
くまばち	熊蜂
くみ	組
くみあ	組み合
くみあい	組合
くみあげ	汲み上げ
くみあげ	組み上げ
くみあわ	組み合わ
くみあわせ	組み合わせ
くみあわせ	組合せ
くみいれ	組み入れ
くみかた	組み方
くみこ	組み込
くみたて	組み立て
くみつ	組み付
くみと	くみ取
くみと	汲み取
くみなお	組み直
くみはん	組版
くみん	区民
くめん	工面
くも	雲
くも	蜘蛛
くも	曇
くもつ	供物
くもま	雲間
くもら	曇ら
くもり	曇
くもん	苦悶
ぐもん	愚問
くや	悔や
くやくしょ	区役所
くやし	悔し
くよう	供養
くら	暗
くら	鞍
くら	食ら
くら	倉
くら	蔵
くら	暮ら
くらい	位
くらいつ	食らいつ
くらがえ	鞍替え
くらがり	暗がり
くらく	苦楽
くらげ	鮓
くらぶ	倶楽部
くらべ	較べ
くらべ	比べ
くらやみ	暗闇
くり	栗
くりあが	繰り上が
くりあげ	繰り上げ
くりいれ	繰り入れ
くりかえ	繰り返
くりかえし	繰返し
くりこ	繰り越
くりこ	繰り込
くりこし	繰越
くりごと	繰言
くりさが	繰り下が
くりさげ	繰り下げ
くりだ	繰り出
くりつ	区立
くりのべ	繰り延べ
くりのべ	繰延
くりひろげ	繰り広げ
くりやま	栗山
くりょ	苦慮
くる	狂
くるし	苦し
ぐるし	苦し
くるしめ	苦しめ
くるま	車
くるまだい	車代
くるみ	胡桃
くれ	暮れ
くれない	紅
ぐれん	紅蓮
くろ	黒
くろいし	黒石
くろう	苦労
ぐろう	愚弄
くろうと	玄人
くろざとう	黒砂糖
くろじ	黒字
くろしお	黒潮
くろず	黒ず
くろつち	黒土
くろぼし	黒星
くろまく	黒幕
くろまめ	黒豆
くろめ	黒目
くろやま	黒山
くわ	桑
くわ	鍬
くわえ	加え
くわけ	区分け
くわし	詳し
くわだて	企て
くわり	区割り
くわわ	加わ
くん	君
くん	薫
くん	訓
ぐん	群
ぐん	軍
ぐん	郡
ぐんい	軍医
くんいく	訓育
ぐんか	軍歌
くんかい	訓戒
ぐんかく	軍拡
ぐんかん	軍艦
ぐんきょ	群居
ぐんこう	軍功
ぐんこう	軍港
くんこく	訓告
ぐんこく	軍国
くんじ	訓示
ぐんし	軍師
ぐんじ	軍事
ぐんしきん	軍資金
くんしゅ	君主
くんしゅ	暈酒
ぐんじゅ	軍需
ぐんしゅう	群衆
ぐんしゅう	群集
ぐんしゅく	軍縮
くんしょう	勲章
くんじょう	薫蒸
くんじょう	燻蒸
ぐんしょう	群小
ぐんしん	軍神
ぐんじん	軍人
くんせい	薫製
くんせい	燻製
ぐんせい	群生
ぐんそう	軍曹
ぐんぞう	群像
ぐんたい	軍隊
ぐんだん	軍団
くんとう	薫陶
くんどう	訓導
ぐんとう	群島
ぐんばい	軍配
ぐんぱつ	群発
ぐんび	軍備
ぐんぶ	群舞
ぐんぶ	軍部
ぐんぶ	郡部
くんぷう	薫風
ぐんもう	群盲
ぐんゆう	群雄
ぐんよう	軍用
くんよみ	訓読み
ぐんらく	群落
くんりん	君臨
くんれい	訓令
くんれん	訓練
くんわ	訓話
け	蹴
け	消
け	毛
げ	下
けい	刑
けい	啓
けい	慶
けい	敬
けい	桂
けい	系
けい	計
げい	芸
けいあい	敬愛
けいい	敬意
けいい	経緯
けいいん	契印
げいいんばしょく	鯨飲馬食
けいえい	経営
けいえん	敬遠
けいか	経過
けいが	慶賀
けいかい	警戒
けいかい	軽快
けいがい	形骸
けいかく	計画
けいかん	景観
けいかん	警官
けいがん	慧眼
けいき	刑期
けいき	契機
けいき	景気
けいき	計器
けいきょもうどう	軽挙妄動
けいきんぞく	軽金属
けいぐ	敬具
けいけい	炯々
げいげき	迎撃
けいけん	敬虔
けいけん	経験
けいげん	軽減
けいこ	稽古
けいご	敬語
けいご	警護
けいこう	傾向
けいこう	携行
けいこう	蛍光
けいこう	鶏口
けいごう	契合
げいごう	迎合
けいこうぎょう	軽工業
けいこうとう	蛍光灯
けいこく	渓谷
けいこく	警告
げいごと	芸事
けいさい	掲載
けいざい	経済
けいざいかい	経済界
けいざいめん	経済面
けいさつ	警察
けいさつかん	警察官
けいさつしょ	警察署
けいさん	珪酸
けいさん	計算
けいさんき	計算機
けいさんしょ	計算書
けいし	警視
けいし	軽視
けいじ	刑事
けいじ	慶事
けいじ	掲示
けいしき	形式
けいじじょう	形而上
けいしつ	形質
けいしゃ	傾斜
げいしゃ	芸者
けいじゅう	軽重
けいしゅく	慶祝
けいしゅつ	掲出
げいじゅつ	芸術
げいしゅん	迎春
けいしょう	形象
けいしょう	敬称
けいしょう	景勝
けいしょう	継承
けいしょう	警鐘
けいしょう	軽傷
けいしょう	軽症
けいじょう	啓上
けいじょう	形状
けいじょう	経常
けいじょう	計上
けいしょく	軽食
けいしん	軽震
けいず	系図
けいすい	軽水
けいすう	係数
けいすう	計数
けいせい	傾城
けいせい	形勢
けいせい	形成
けいせき	形跡
けいせつ	蛍雪
けいせん	経線
けいせん	罫線
けいそ	硅素
けいそう	係争
けいそう	形相
けいそう	軽装
けいぞう	恵贈
けいそく	計測
けいぞく	継続
けいそつ	軽率
けいたい	形態
けいたい	携帯
けいだい	境内
けいちつ	啓蟄
けいちゅう	傾注
けいちょう	傾聴
けいちょう	慶弔
けいちょう	軽重
けいちょうふはく	軽佻浮薄
けいてい	兄弟
けいてき	警笛
けいでんき	継電器
けいと	毛糸
けいど	経度
けいど	軽度
けいとう	傾倒
けいとう	系統
げいとう	芸当
けいとうじゅ	系統樹
げいにん	芸人
けいねん	経年
げいのう	芸能
げいのうじん	芸能人
けいば	競馬
げいは	鯨波
けいばい	競売
けいはく	軽薄
けいはつ	啓発
けいばつ	刑罰
けいばつ	閨閥
けいはんざい	軽犯罪
けいひ	経費
けいび	警備
けいび	軽微
けいひん	景品
げいひん	迎賓
げいひんかん	迎賓館
けいふ	系譜
けいぶ	警部
けいぶ	軽侮
けいふく	敬服
けいべつ	軽蔑
けいべん	軽便
けいほう	刑法
けいほう	警報
けいぼう	閨房
けいみょう	軽妙
けいむしょ	刑務所
げいめい	芸名
けいもう	啓蒙
けいやく	契約
けいやくしょ	契約書
けいゆ	経由
けいゆ	軽油
けいよ	恵与
けいよう	形容
けいよう	掲揚
けいようし	形容詞
けいらん	鶏卵
けいり	経理
けいりゃく	計略
けいりゅう	係留
けいりゅう	渓流
けいりゅう	繋留
けいりょう	計量
けいりん	競輪
けいるい	係累
けいれい	敬礼
けいれき	経歴
けいれつ	系列
けいろ	経路
けいろう	敬老
けおと	蹴落と
けおりもの	毛織物
けが	汚
けが	怪我
げか	外科
げかい	下界
げかい	外科医
げかい	外界
けがらわし	汚らわし
けがれ	汚れ
けがわ	毛皮
げかん	下巻
げき	劇
げき	激
げき	檄
げきか	激化
げきが	劇画
げきから	激辛
げきげん	激減
げきさん	激賛
げきしょ	激暑
げきじょう	劇場
げきじょう	激情
げきしょく	激職
げきしん	撃針
げきしん	激震
げきせん	激戦
げきぞう	激増
げきたい	撃退
げきだん	劇団
げきつい	撃墜
げきつう	激痛
げきてき	劇的
げきど	激怒
げきとう	激闘
げきどう	激動
げきとつ	激突
げきは	撃破
げきはつ	激発
げきへん	激変
げきむ	激務
げきめつ	撃滅
げきやく	劇薬
けぎらい	気嫌い
げきりゅう	激流
げきりん	逆鱗
げきれい	激励
げきれつ	激烈
げきろん	激論
げこ	下戸
げこう	下校
けさ	袈裟
けさ	今朝
げざい	下剤
げざん	下山
けし	芥子
けし	消し
げし	夏至
けしいん	消印
けしき	気色
けしき	景色
けしきば	気色ば
けしごむ	消しゴム
けしとめ	消し止め
げしゃ	下車
げしゅく	下宿
げじゅん	下旬
けしょう	化粧
けしょうひん	化粧品
けしん	化身
けず	削
げすい	下水
げすいどう	下水道
けずりと	削り取
げせん	下船
げせん	下賎
けそう	懸想
げそく	下足
げそくばこ	下足箱
げそくばん	下足番
けた	桁
げた	下駄
けだか	気高
けたちがい	桁違い
げだつ	解脱
げたばこ	下駄箱
げだん	下段
けっ	決
けつ	決
けつあつ	血圧
けつい	決意
けついん	欠員
けつえき	血液
けつえきがた	血液型
けつえん	血縁
けっか	欠課
けっか	結果
げっか	月下
けっかい	決壊
けっかい	結界
けっかく	欠格
けっかく	結核
げつがく	月額
けっかん	欠陥
けっかん	血管
げっかん	月刊
げっかん	月間
けっき	決起
けつぎ	決議
けっきゅう	血球
げっきゅう	月給
けっきょく	結局
けっきん	欠勤
げっけい	月経
げっけいじゅ	月桂樹
けつげん	結言
けっこう	欠航
けっこう	決行
けっこう	結構
けっこう	血行
けつごう	結合
げっこう	激昂
げっこう	月光
けっこん	結婚
けっこん	血痕
けっこんしき	結婚式
けっさい	決済
けっさい	決裁
けっさく	傑作
けっさん	決算
げっさん	月産
けっし	決死
げつじ	月次
けつじつ	結実
けっして	決して
けっしゃ	結社
げっしゃ	月謝
けっしゅう	結集
げっしゅう	月収
けっしゅつ	傑出
けつじょ	欠如
けっしょう	決勝
けっしょう	結晶
けつじょう	欠場
けっしょうせん	決勝戦
けっしょうばん	血小板
けっしょく	欠食
けっしょく	血色
げっしょく	月食
けっしん	決心
けっしん	結審
けっせい	結成
けっせい	血清
けっせき	欠席
けっせき	結石
けっせん	決戦
けっせん	結線
けっせん	血栓
けっそう	血相
けっそく	結束
けつぞく	血族
けっそん	欠損
けったく	結託
けつだん	決断
けつだん	結団
けっちゃく	決着
けっちん	血沈
けってい	決定
けってん	欠点
けっとう	決闘
けっとう	結党
けっとう	血糖
けっとう	血統
けっとば	蹴っ飛ば
けっぱく	潔白
けつばん	欠番
げっぷ	月賦
げっぺい	月餅
けっぺき	潔癖
けつべつ	決別
けつべつ	訣別
けつぼう	欠乏
げっぽう	月俸
げっぽう	月報
けつまくえん	結膜炎
けつまつ	結末
けつまづ	蹴つまづ
げつまつ	月末
けつみゃく	血脈
けつめい	結盟
げつよう	月曜
げつようび	月曜日
けつらく	欠落
げつり	月利
けつりゅう	血流
けつれい	欠礼
げつれい	月例
げつれい	月齢
けつれつ	決裂
けつろ	結露
けつろん	結論
げどく	解毒
けとば	蹴飛ば
けな	貶
けなげ	健気
けなみ	毛並
げねつ	解熱
げねつざい	解熱剤
けねん	懸念
げば	下馬
けはい	気配
げびた	下卑た
けびょう	仮病
げひん	下品
けぶか	毛深
げぼく	下僕
けむ	煙
けむし	毛虫
けむた	煙た
けむり	煙
けもの	獣
けやき	欅
けらい	家来
げらく	下落
げり	下痢
げりゃく	下略
げれつ	下劣
けわし	険し
けん	件
けん	健
けん	券
けん	剣
けん	検
けん	献
けん	県
けん	賢
けん	軒
けん	験
けん	腱
げん	弦
げん	減
げん	玄
げん	現
げん	言
けんあく	険悪
げんあつ	減圧
けんあん	懸案
けんあん	検案
げんあん	原案
けんい	権威
けんいん	検印
けんいん	牽引
げんいん	原因
けんえい	兼営
けんえい	県営
げんえい	幻影
けんえき	検疫
げんえき	原液
げんえき	減益
げんえき	現役
けんえつ	検閲
けんえん	嫌煙
けんえん	犬猿
けんお	嫌悪
けんおん	検温
けんか	喧嘩
けんか	県下
げんか	原価
げんか	減価
げんか	現下
げんか	言下
げんが	原画
けんかい	県会
けんかい	見解
けんがい	圏外
けんがい	懸崖
けんがい	県外
げんかい	厳戒
げんかい	限界
げんがい	言外
げんかいち	限界値
けんかく	懸隔
けんがく	見学
げんかく	厳格
げんかく	幻覚
げんがく	弦楽
げんがく	減額
げんがく	衒学
けんかごし	喧嘩腰
げんかしょうきゃく	減価償却
けんがん	検眼
げんかん	厳寒
げんかん	玄関
けんぎ	嫌疑
けんぎ	建議
けんぎ	県議
げんき	元気
けんきゃく	健脚
げんきゃく	減却
けんきゅう	研究
げんきゅう	減給
げんきゅう	言及
けんきゅうかい	研究会
けんきゅうしつ	研究室
けんきゅうじょ	研究所
けんきょ	検挙
けんきょ	謙虚
けんぎょう	兼業
げんきょう	元凶
げんきょう	現況
げんぎょう	現業
けんきん	献金
げんきん	厳禁
げんきん	現金
けんけい	県警
げんけい	原型
げんけい	原形
げんけい	減刑
けんけつ	献血
けんげん	権限
けんげん	顕現
けんご	堅固
げんご	原語
げんご	言語
けんこう	健康
けんこう	軒昂
けんごう	剣豪
げんこう	原稿
げんこう	現行
げんこう	言行
げんごう	元号
けんこうこつ	肩甲骨
げんこうはん	現行犯
けんこうほけん	健康保険
けんこく	建国
げんこく	原告
けんさ	検査
けんざい	健在
けんざい	建材
けんざい	顕在
げんさい	減殺
げんざい	原罪
げんざい	現在
げんざいりょう	原材料
けんさく	検索
けんさく	献策
けんさく	研削
げんさく	原作
けんさつ	検察
けんさつ	検札
けんさつ	賢察
けんさつかん	検察官
けんざん	検算
げんさん	原産
げんさん	減産
げんざん	減算
げんさんち	原産地
けんし	検死
けんし	検視
けんし	犬歯
けんじ	健児
けんじ	堅持
けんじ	検事
けんじ	献辞
けんじ	顕示
げんし	原始
げんし	原子
げんし	原紙
げんし	幻視
げんし	減資
げんじ	源氏
げんじ	現示
げんしかく	原子核
けんしき	見識
けんじつ	堅実
げんじつ	現実
げんじつみ	現実味
げんじてん	現時点
けんじゃ	賢者
けんしゅ	券種
げんしゅ	元首
げんしゅ	原種
げんしゅ	原酒
げんしゅ	厳守
けんしゅう	検収
けんしゅう	研修
けんじゅう	拳銃
げんしゅう	減収
げんじゅう	厳重
げんじゅうしょ	現住所
げんじゅうみん	原住民
げんしゅく	厳粛
けんしゅつ	検出
げんしょ	原初
げんしょ	原書
けんしょう	健勝
けんしょう	憲章
けんしょう	懸賞
けんしょう	検証
けんしょう	肩章
けんじょう	献上
けんじょう	謙譲
げんしょう	減少
げんしょう	現象
げんじょう	原状
げんじょう	現状
けんしょく	兼職
げんしょく	原色
げんしょく	減食
げんしょく	現職
げんしりょく	原子力
げんしろ	原子炉
けんしん	検診
けんしん	検針
けんしん	献身
けんじん	県人
けんじん	賢人
げんず	原図
けんすい	懸垂
げんすい	元帥
げんすい	減水
げんすい	減衰
げんすいばく	原水爆
けんすう	件数
けんすう	軒数
げんすう	減数
げんすん	原寸
げんせ	現世
けんせい	権勢
けんせい	牽制
けんせい	県政
げんせい	厳正
げんぜい	減税
げんせき	原石
けんせつ	建設
げんせつ	言説
けんせん	健羨
けんぜん	健全
げんせん	厳選
げんせん	源泉
げんぜん	厳然
けんそ	倹素
けんそ	険阻
げんそ	元素
けんそう	喧騒
けんそう	喧躁
けんぞう	建造
げんそう	幻想
げんそう	現送
げんぞう	現像
けんぞうぶつ	建造物
けんぞく	眷族
げんそく	原則
げんそく	減速
げんぞく	還俗
けんそん	謙遜
げんそん	減損
げんそん	現存
げんぞん	現存
けんたい	倦怠
げんたい	減退
げんだい	原題
げんだい	現代
けんたいかん	倦怠感
けんたいき	倦怠期
げんだいじん	現代人
げんたつ	厳達
けんたん	健啖
げんたん	減反
けんち	検知
けんち	見地
げんち	現地
げんち	言質
けんちく	建築
けんちくし	建築士
けんちょ	顕著
げんちょ	原著
けんちょう	健聴
けんちょう	県庁
げんちょう	幻聴
げんつき	原付
けんてい	検定
けんてい	献呈
げんてい	限定
げんていばん	限定版
けんでん	喧伝
げんてん	原典
げんてん	原点
げんてん	減点
げんど	限度
けんとう	健闘
けんとう	検討
けんとう	見当
けんどう	剣道
けんどう	県道
げんとう	厳冬
げんとう	幻灯
げんどう	原動
げんどう	言動
けんとうかい	検討会
げんどうき	原動機
げんどうりょく	原動力
けんとし	ケント紙
けんどちょうらい	捲土重来
けんない	圏内
けんない	県内
けんなん	険難
げんに	現に
けんにょう	検尿
けんにん	兼任
げんにん	現任
けんのう	権能
けんのう	献納
げんのう	玄能
けんのん	剣呑
げんば	現場
げんぱい	減配
けんばいき	券売機
げんばく	原爆
げんばつ	厳罰
げんぱつ	原発
けんばん	鍵盤
げんばん	原盤
けんび	兼備
げんぴ	厳秘
けんびきょう	顕微鏡
げんぴん	現品
けんぷ	絹布
げんぷ	厳父
げんぷう	厳封
げんぶがん	玄武岩
けんぶつ	見物
げんぶつ	現物
けんぶん	検分
けんぶん	見聞
げんぶん	原文
けんぺい	憲兵
けんぺい	権柄
けんぺいりつ	建蔽率
けんべん	検便
けんぽ	健保
げんぼ	原簿
けんぽう	憲法
けんぽう	拳法
げんぽう	減俸
けんぼうしょう	健忘症
げんぼく	原木
けんぽん	献本
げんぽん	原本
けんま	研磨
げんまい	玄米
げんみつ	厳密
けんみん	県民
けんむ	兼務
けんめい	件名
けんめい	懸命
けんめい	賢明
げんめい	厳命
げんめい	言明
げんめつ	幻滅
げんめん	減免
けんもん	検問
げんや	原野
けんやく	倹約
げんゆ	原油
げんゆう	現有
けんよう	兼用
げんよう	現用
けんり	権利
げんり	原理
けんりつ	県立
げんりゅう	源流
けんりょう	見料
げんりょう	原料
げんりょう	減量
げんりょうし	限量子
けんりょく	権力
けんろう	堅牢
げんろく	元禄
げんろん	原論
げんろん	言論
げんわく	幻惑
げんわく	眩惑
こ	越
こ	凝
こ	個
こ	呼
こ	弧
こ	戸
こ	鼓
こ	乞
こ	漉
こ	込
こ	混
こ	子
こ	小
こ	請
こ	漕
こ	超
こ	濃
こ	粉
こ	娘
こ	恋
ご	五
ご	伍
ご	碁
ご	語
ごあいこ	ご愛顧
ごあいこ	御愛顧
ごあいさつ	ご挨拶
ごあいさつ	御挨拶
ごあいよう	ご愛用
ごあいよう	御愛用
ごあんない	ご案内
ごあんない	御案内
こい	故意
こい	鯉
こい	請い
こい	恋
ごい	語意
ごい	語彙
こいけ	小池
こいし	小石
こいし	恋し
こいじ	恋路
ごいちどうさま	御一同様
ごいっしょ	ご一緒
ごいっしょ	御一緒
ごいっとうさま	御一統様
ごいっぽう	御一報
こいぬ	仔犬
こいびと	恋人
こいぶみ	恋文
ごいらい	ご依頼
ごいらい	御依頼
こう	候
こう	光
こう	功
こう	口
こう	孔
こう	抗
こう	昂
こう	校
こう	港
こう	甲
こう	稿
こう	航
こう	講
こう	項
こう	高
こう	頁
ごう	業
ごう	剛
ごう	号
ごう	合
ごう	豪
こうあつ	高圧
こうあん	公安
こうあん	考案
こうい	厚意
こうい	好意
こうい	更衣
こうい	校医
こうい	行為
こうい	高位
ごうい	合意
こういき	広域
こういしょう	後遺症
こういってん	紅一点
こういん	光陰
こういん	公印
こういん	工員
こういん	拘引
こういん	荒淫
こういん	行員
ごういん	強引
こうう	降雨
ごうう	豪雨
こううん	好運
こううん	幸運
こううんき	耕耘機
こうえい	後衛
こうえい	光栄
こうえい	公営
こうえき	交易
こうえき	公益
こうえき	公役
こうえつ	校閲
こうえん	後援
こうえん	公園
こうえん	公演
こうえん	好演
こうえん	講演
こうおつ	甲乙
こうおん	恒温
こうおん	高温
こうおん	高音
こうか	効果
こうか	工科
こうか	校歌
こうか	硬化
こうか	硬貨
こうか	考課
こうか	降下
こうか	高価
こうか	高架
こうが	高雅
ごうか	豪華
こうかい	後悔
こうかい	公海
こうかい	公開
こうかい	更改
こうかい	航海
こうがい	公害
こうがい	口外
こうがい	校外
こうがい	梗概
こうがい	構外
こうがい	郊外
こうがい	慷慨
ごうかい	豪快
ごうがい	号外
こうかいどう	公会堂
こうかがく	光化学
こうかく	広角
こうかく	甲殻
こうかく	降格
こうがく	後学
こうがく	光学
こうがく	向学
こうがく	工学
こうがく	高額
ごうかく	合格
こうがくねん	高学年
こうがくぶ	工学部
こうかつ	狡猾
こうがっか	工学科
こうかふこうか	幸か不幸か
こうかん	交感
こうかん	交換
こうかん	交歓
こうかん	好感
こうかん	鋼管
こうかん	高官
こうがん	厚顔
こうがん	紅顔
こうがん	睾丸
ごうかん	強姦
こうかんき	交換器
こうかんき	交換機
こうがんむち	厚顔無恥
こうき	後期
こうき	後記
こうき	好奇
こうき	好機
こうき	工期
こうき	広軌
こうき	高貴
こうぎ	広義
こうぎ	抗議
こうぎ	講義
こうぎ	高誼
ごうき	剛毅
ごうぎ	合議
ごうぎ	豪儀
こうきしん	好奇心
こうきゅう	後宮
こうきゅう	公休
こうきゅう	恒久
こうきゅう	硬球
こうきゅう	講究
こうきゅう	高級
こうきゅう	高給
ごうきゅう	号泣
こうきょ	皇居
こうきょ	薨去
こうきょう	交響
こうきょう	公共
こうきょう	好況
こうきょう	広狭
こうぎょう	興業
こうぎょう	興行
こうぎょう	工業
こうぎょう	鉱業
こうきょうがく	交響楽
こうきょうきょく	交響曲
こうきょうぶつ	公共物
こうきん	公金
こうきん	拘禁
ごうきん	合金
こうきんり	高金利
こうく	校区
こうぐ	工具
こうくう	航空
こうくう	高空
こうぐう	皇宮
こうくうき	航空機
こうくうけん	航空券
こうぐん	行軍
こうけい	後継
こうけい	光景
こうけい	口径
こうげい	工芸
ごうけい	合計
こうげき	攻撃
こうけつ	高潔
ごうけつ	豪傑
こうけつあつ	高血圧
こうけん	後見
こうけん	貢献
こうげん	光源
こうげん	公言
こうげん	高原
ごうけん	剛健
こうげんびょう	膠原病
こうこ	公庫
こうこ	江湖
こうこ	考古
こうご	交互
こうご	口語
ごうご	豪語
こうこう	後攻
こうこう	孝行
こうこう	膏肓
こうこう	航行
こうこう	高校
こうこう	煌々
こうごう	皇后
ごうごう	轟々
こうごうし	神々し
こうこうせい	高校生
こうごうせい	光合成
こうこく	公告
こうこく	公国
こうこく	広告
こうこつ	硬骨
こうこつ	恍惚
こうさ	黄砂
こうさ	較差
こうさ	交差
こうさ	公差
こうさ	考査
こうざ	口座
こうざ	講座
こうさい	交際
こうさい	公債
こうさい	高裁
こうさい	虹彩
こうざい	鋼材
こうさく	交錯
こうさく	工作
こうさく	耕作
こうさく	鋼索
こうさつ	絞殺
こうさつ	考察
こうさつ	高察
こうさつ	高札
こうさん	公算
こうさん	鉱産
こうさん	降参
こうざん	鉱山
こうざん	高山
こうし	格子
こうし	公使
こうし	公司
こうし	公私
こうし	厚志
こうし	皇子
こうし	行使
こうし	講師
こうし	仔牛
こうじ	公示
こうじ	工事
こうじ	高次
こうじ	麹
こうじ	小路
こうじ	糀
ごうし	合資
ごうじ	合字
ごうしがいしゃ	合資会社
こうしき	公式
こうしき	硬式
こうしつ	皇室
こうしつ	硬質
こうじつ	口実
こうしど	格子戸
こうしゃ	後者
こうしゃ	公社
こうしゃ	校舎
こうしゃ	降車
ごうしゃ	豪奢
こうしゃく	候爵
こうしゃく	公爵
こうしゃく	講釈
こうしゅ	攻守
こうじゅ	口授
こうしゅう	公衆
こうしゅう	口臭
こうしゅう	講習
こうしゅうかい	講習会
こうしゅうでんわ	公衆電話
こうじゅつ	後述
こうじゅつ	口述
こうじゅつ	講述
こうじゅん	公準
こうしょ	向暑
こうしょ	高所
こうじょ	公序
こうじょ	控除
こうしょう	交渉
こうしょう	公称
こうしょう	公証
こうしょう	好尚
こうしょう	工廠
こうしょう	工厰
こうしょう	校章
こうしょう	考証
こうしょう	高尚
こうしょう	哄笑
こうじょう	厚情
こうじょう	口上
こうじょう	向上
こうじょう	工場
こうじょう	恒常
ごうしょう	豪商
ごうじょう	強情
こうじょうせん	甲状腺
こうしょく	交織
こうしょく	公職
こうしょく	好色
こうじろう	孝二郎
こうしん	後進
こうしん	交信
こうしん	更新
こうしん	行進
こうしん	高進
こうじん	後塵
こうじん	幸甚
こうしんじょ	興信所
こうしんらい	高信頼
こうしんりょう	香辛料
こうず	構図
こうすい	硬水
こうすい	降水
こうすい	香水
こうずい	洪水
こうすいじゅん	高水準
こうすう	工数
ごうすう	号数
こうずか	好事家
こうせい	後世
こうせい	後生
こうせい	公正
こうせい	厚生
こうせい	向性
こうせい	恒星
こうせい	抗生
こうせい	攻勢
こうせい	更正
こうせい	更生
こうせい	校正
こうせい	校生
こうせい	構成
こうせい	硬性
ごうせい	剛性
ごうせい	合成
ごうせい	豪勢
こうせいいん	構成員
こうせいせき	好成績
こうせいのう	高性能
こうせき	功績
こうせき	鉱石
こうせつ	巧拙
こうせつ	降雪
ごうせつ	豪雪
こうせん	交戦
こうせん	光線
こうせん	公選
こうせん	鉱泉
こうせん	高専
こうぜん	公然
こうせんてき	好戦的
こうそ	公訴
こうそ	控訴
こうそ	酵素
こうぞ	楮
ごうそ	強訴
こうそう	後送
こうそう	広壮
こうそう	抗争
こうそう	構想
こうそう	降霜
こうそう	高僧
こうそう	高層
こうぞう	構造
こうぞうか	構造化
こうそく	光速
こうそく	拘束
こうそく	校則
こうそく	梗塞
こうそく	高速
こうぞく	後続
こうぞく	皇族
ごうぞく	豪族
こうそしん	控訴審
こうそつ	高卒
こうた	小唄
こうた	小歌
こうたい	後退
こうたい	交替
こうたい	交代
こうだい	広大
ごうたい	剛体
こうたいごう	皇太后
こうたいし	皇太子
こうたく	光沢
ごうだつ	強奪
こうたん	後端
こうたん	降誕
こうだん	後段
こうだん	公団
こうだん	講壇
こうだん	講談
ごうたん	剛胆
ごうたん	豪胆
こうだんし	好男子
こうち	巧遅
こうち	拘置
こうち	耕地
こうちく	構築
こうちゃ	紅茶
こうちゃく	降着
こうちゃく	膠着
こうちょう	好調
こうちょう	校長
こうちょう	紅潮
こうちょう	高潮
こうちょうかい	公聴会
こうちょうは	高調波
こうちょく	硬直
ごうちょく	剛直
こうちん	工賃
こうつう	交通
こうつうきかん	交通機関
こうつうもう	交通網
ごうつくばり	業つくばり
こうつごう	好都合
こうてい	公定
こうてい	公邸
こうてい	工程
こうてい	校庭
こうてい	校訂
こうてい	皇帝
こうてい	肯定
こうてい	行程
こうてい	高低
こうでい	拘泥
こうてき	公的
こうてき	好適
こうてきしゅ	好敵手
こうてつ	更迭
こうてつ	鋼鉄
こうてん	後天
こうてん	交点
こうてん	公転
こうてん	好天
こうてん	好転
こうでん	香典
こうど	黄土
こうど	高度
こうとう	口頭
こうとう	喉頭
こうとう	恒等
こうとう	江東
こうとう	高等
こうとう	高騰
こうどう	黄道
こうどう	公道
こうどう	坑道
こうどう	行動
こうどう	講堂
ごうとう	強盗
ごうどう	合同
こうとうしき	恒等式
こうとうぶ	後頭部
こうとうむけい	荒唐無稽
こうとく	公徳
こうどく	購読
こうない	校内
こうない	構内
こうない	港内
こうないえん	口内炎
こうなん	硬軟
こうにゅう	購入
こうにん	後任
こうにん	公認
こうねつ	光熱
こうねつ	高熱
こうねん	後年
こうねん	高年
こうねんき	更年期
こうのう	効能
こうは	光波
こうは	硬派
こうば	工場
こうはい	後輩
こうはい	荒廃
こうはい	高配
こうばい	勾配
こうばい	紅梅
こうばい	購買
こうはく	紅白
こうばし	香ばし
ごうはら	業腹
こうはん	撹拌
こうはん	後半
こうはん	公判
こうはん	広範
こうばん	交番
ごうはん	合板
こうはんい	広範囲
こうひ	公費
こうひ	工費
こうび	後尾
こうび	交尾
ごうひ	合否
こうひつ	硬筆
ごうひつ	合筆
こうひょう	公表
こうひょう	好評
こうひょう	講評
こうひん	公賓
こうふ	交付
こうふ	公布
こうぶ	後部
こうふう	校風
こうふく	幸福
こうふく	降伏
こうぶつ	好物
こうぶつ	鉱物
こうふん	興奮
こうぶんしょ	公文書
こうへい	公平
こうへん	後編
こうべん	抗弁
ごうべん	合弁
こうほ	候補
こうぼ	公募
こうぼ	酵母
こうほう	後方
こうほう	公報
こうほう	工法
こうほう	広報
こうほう	航法
こうぼう	興亡
こうぼう	好防
こうぼう	工房
こうぼう	攻防
ごうほう	号砲
ごうほう	合法
ごうほう	豪放
ごうほうらいらく	豪放磊落
こうぼく	公僕
こうぼく	高木
こうまい	高邁
こうまん	高慢
ごうまん	ごう慢
ごうまん	傲慢
こうみ	香味
こうみつ	高密
こうみゃく	鉱脈
こうみょう	巧妙
こうみん	公民
こうみんかん	公民館
こうむ	公務
こうむ	被
こうむいん	公務員
こうむてん	工務店
こうめい	公明
こうめい	高名
ごうめい	合名
ごうめいがいしゃ	合名会社
こうめいせいだい	公明正大
ごうも	毫も
ごうもう	剛毛
こうもく	項目
こうもくすう	項目数
こうもり	蝙蝠
こうもん	校門
こうもん	肛門
ごうもん	拷問
こうや	広野
こうや	荒野
こうやく	公約
こうやく	口約
こうやく	膏薬
こうゆう	交友
こうゆう	交遊
こうゆう	公有
こうよう	公用
こうよう	効用
こうよう	昂揚
こうよう	紅葉
こうよう	高揚
ごうよく	強欲
こうら	甲羅
こうらく	行楽
こうらん	撹乱
こうらん	高覧
こうり	功利
こうり	行李
こうり	高利
こうり	小売
ごうり	合理
ごうりき	強力
こうりつ	公立
こうりつ	効率
こうりつ	高率
こうりつか	効率化
こうりゃく	後略
こうりゃく	攻略
こうりゅう	興隆
こうりゅう	交流
こうりゅう	拘留
ごうりゅう	合流
こうりょ	考慮
こうりょう	稿料
こうりょう	荒涼
こうりょう	講料
こうりょう	香料
こうりょく	効力
こうりょく	抗力
こうりん	降臨
こうれい	交霊
こうれい	好例
こうれい	恒例
こうれい	高齢
ごうれい	号令
こうれつ	後列
こうろ	航路
こうろ	香炉
こうろ	高炉
こうろう	功労
こうろん	公論
こうろん	口論
こうわ	講和
こうわ	講話
こうわん	港湾
ごうわん	剛腕
こえ	越え
こえ	声
こえ	超え
こえ	肥
こえ	肥え
ごえい	護衛
ごえいてん	ご栄転
ごえいてん	御栄転
こえがわり	声変り
こえがわり	声変わり
こえだ	小枝
ごえつどうしゅう	呉越同舟
ごえんじょ	ご援助
ごえんじょ	御援助
こお	凍
こお	氷
こおう	呼応
ごおうぼ	ご応募
ごおうぼ	御応募
こおとこ	小男
こーひー	珈琲
こおり	郡
こおり	氷
こおりざとう	氷砂糖
こおりつ	凍り付
ごおんこ	ご恩顧
ごおんこ	御恩顧
こか	固化
こが	焦が
こがい	戸外
ごかい	誤解
こがいしゃ	子会社
ごかいそう	ご会葬
ごかいそう	御会葬
ごかいとう	ご回答
ごかいとう	御回答
ごがく	語学
ごかくにん	ご確認
ごかくにん	御確認
こかげ	木陰
ごかぞく	ご家族
ごかぞく	御家族
こがた	小型
こがた	小形
こがたき	小型機
こかつ	枯渇
ごかつやく	ご活躍
ごかつやく	御活躍
ごかてい	ご家庭
ごかてい	御家庭
こがね	黄金
こがら	小柄
こがらし	木枯し
ごかん	互換
ごかん	語幹
ごかん	語感
ごがん	護岸
ごかんき	互換機
ごかんじょ	ご寛恕
ごかんじょ	御寛恕
ごかんせい	互換性
ごかんづき	ご勘づき
ごかんづき	ご感づき
ごかんよう	ご寛容
ごかんよう	御寛容
こき	古希
こき	古稀
こき	呼気
こき	子機
ごき	語気
ごき	誤記
ごきげん	ご機嫌
こきざみ	小刻み
ごきたい	ご期待
ごきたい	御期待
こぎつ	こぎ着
こきつか	こき使
こぎって	小切手
ごきにゅう	ご記入
ごきにゅう	御記入
ごきぼう	ご希望
ごきぼう	御希望
こぎみよ	小気味よ
こきゃく	顧客
こきゅう	呼吸
こきゅう	胡弓
こきょう	故郷
ごぎょう	五行
ごきょうりょく	ご協力
ごきょうりょく	御協力
こく	刻
こく	酷
ごく	極
ごく	語句
ごくあく	極悪
こくい	国威
ごくい	極意
こくいん	刻印
こくう	虚空
こくう	穀雨
こくえい	国営
こくえき	国益
こくおう	国王
こくがい	国外
こくぎ	国技
こくこ	国庫
こくご	国語
こくさい	国債
こくさい	国際
こくさいか	国際化
こくさいせん	国際線
こくさく	国策
こくさん	国産
こくさんしゃ	国産車
こくし	国史
こくし	酷使
こくじ	告示
こくじ	国事
こくじ	国璽
こくじ	酷似
こくしむそう	国士無双
ごくしゃ	獄舎
こくしょ	国書
こくしょ	酷暑
こくじょう	国情
ごくじょう	極上
こくじょく	国辱
こくじん	黒人
こくせい	国勢
こくせい	国政
こくぜい	国税
こくせき	国籍
こくせん	国選
こくそ	告訴
こくだい	国大
こくだか	石高
こくち	告知
こぐち	小口
こくてい	国定
こくでん	国電
こくど	国土
こくどう	国道
こくない	国内
こくないせん	国内線
こくはく	告白
こくはく	酷薄
こくはつ	告発
こくばん	黒板
こくひ	国費
ごくひ	極秘
こくひょう	酷評
こくひん	国賓
ごくひん	極貧
こくふく	克服
こくべつ	告別
こくほ	国保
こくほう	国宝
こくぼう	国防
こくぼうそうしょう	国防総省
こぐま	子熊
こくみん	国民
こくみんかいへい	国民皆兵
こくむ	国務
こくめい	克明
こくめい	国名
こくもつ	穀物
こくゆう	国有
こくようせき	黒曜石
ごくらく	極楽
こくりつ	国立
こくるい	穀類
こくれん	国連
ごくろう	ご苦労
ごくろう	御苦労
ごくろうさま	ご苦労さま
ごくろうさま	御苦労様
こくろん	国論
こけ	苔
こげ	焦げ
ごけ	後家
こけい	固形
ごけい	互恵
こげつ	焦げ付
ごけっこん	ご結婚
ごけっこん	御結婚
ごけっせき	ご欠席
ごけっせき	御欠席
ごけん	護憲
ごげん	語源
ごけんしょう	ご健勝
ごけんしょう	御健勝
ごけんとう	ご検討
ごけんとう	御検討
ここ	個々
こご	古語
ごご	午後
ごご	午后
ごこう	後光
ごこうい	ご厚意
ごこうい	ご好意
ごこうい	御厚意
ごこうい	御好意
ごこうぎ	ご高誼
ごこうぎ	御高誼
ごこうし	ご厚志
ごこうし	御厚志
ごこうじょう	ご厚情
ごこうじょう	御厚情
ごこうはい	ご高配
ごこうはい	御高配
ごこうらん	ご高覧
ごこうらん	御高覧
こごえ	凍え
ここく	故国
ごこく	五穀
ごこく	護国
ここじん	個々人
ここち	心地
ごこち	心地
ここちよ	心地よ
こごと	小言
ここのか	9日
ここのか	９日
ここのか	九日
ここのそじ	九十路
ここのつ	九つ
こころ	心
こころある	心ある
こころいき	心意気
こころえ	心得
こころがけ	心がけ
こころがけ	心掛け
こころがまえ	心構え
こころから	心から
こころざし	志
こころづけ	心付け
こころづよ	心強
こころな	心無
こころない	心ない
こころね	心根
こころのこり	心残り
こころぼそ	心細
こころまち	心待ち
こころみ	試み
こころもち	心持ち
こころもとな	心許な
こころゆ	心行
こころよ	快
ここん	古今
ごこんじょう	ご懇情
ごこんじょう	御懇情
ごこんせつ	ご懇切
ごこんせつ	御懇切
ごさ	誤差
ごさい	後妻
こざいく	小細工
こざかし	小賢し
こさつ	古刹
こさめ	小雨
こさん	古参
ごさんか	ご参加
ごさんか	御参加
ごさんれつ	ご参列
ごさんれつ	御参列
こし	枯死
こし	腰
こし	輿
こじ	居士
こじ	古寺
こじ	固持
こじ	固辞
こじ	孤児
こじ	故事
こじ	誇示
ごし	越し
ごし	腰
ごじ	誤字
ごじ	護持
ごじあい	ご自愛
ごじあい	御自愛
こじあけ	こじ開け
ごしえん	ご支援
ごしえん	御支援
こしかけ	腰かけ
こしかけ	腰掛け
こしき	古式
こしき	甑
こじき	乞食
こしたんたん	虎視眈々
こしつ	個室
こしつ	固執
ごじつ	後日
ごしつもん	ご質問
ごしつもん	御質問
ごしどう	ご指導
ごしどう	御指導
こしぬけ	腰抜け
こじま	小島
ごしゃ	誤射
こしゃく	小癪
ごしゃく	語釈
こしゅ	固守
こしゅ	戸主
こじゅ	古樹
こしゅう	固執
ごじゅう	五重
ごじゅうおん	五十音
ごじゅうしょ	ご住所
ごじゅうしょ	御住所
こじゅうと	小姑
ごしゅうにん	ご就任
ごしゅうにん	御就任
ごしゅじん	ご主人
ごしゅじん	御主人
ごしゅっせき	ご出席
ごしゅっせき	御出席
ごじゅっぽひゃっぽ	五十歩百歩
ごじゅん	語順
こしょ	古書
ごしょ	御所
ごじょ	互助
こしょう	呼称
こしょう	故障
こしょう	湖沼
こしょう	胡椒
こじょう	古城
ごしょう	後生
ごしよう	ご使用
ごしよう	御使用
ごじょう	互譲
ごしょうかい	ご照会
ごしょうかい	ご紹介
ごしょうかい	御照会
ごしょうかい	御紹介
ごしょうたい	ご招待
ごしょうたい	御招待
ごしょうち	ご承知
ごしょうち	御承知
ごしょく	誤植
こじん	個人
こじん	故人
ごしん	誤信
ごしん	誤診
ごしん	護身
ごじん	御仁
こす	擦
こすい	湖水
こすう	個数
こすう	戸数
ごすう	語数
こずえ	梢
こすっから	こすっ辛
こせい	個性
ごせい	悟性
ごせいうん	ご盛運
ごせいうん	御盛運
ごせいえい	ご清栄
ごせいえい	御清栄
ごせいきゅう	ご請求
ごせいきゅう	御請求
ごせいぎょう	ご盛業
ごせいぎょう	御盛業
ごせいしょう	ご清勝
ごせいしょう	ご清祥
ごせいしょう	御清勝
ごせいしょう	御清祥
ごせいだい	ご盛大
ごせいだい	御盛大
ごせいらん	御清覧
こせき	古跡
こせき	戸籍
こぜつ	孤絶
こぜに	小銭
こせん	古銭
ごせん	互選
ごぜん	午前
ごぜん	御前
こせんきょう	跨線橋
ごせんし	五線紙
ごせんぞ	ご先祖
ごせんぞ	御先祖
ごせんふ	五線譜
こぞう	小僧
ごそう	誤想
ごそう	護送
ごそうさ	誤操作
ごそうだん	ご相談
ごそうだん	御相談
ごそうふ	ご送付
ごそうふ	御送付
こそく	姑息
ごそくろう	ご足労
ごそくろう	御足労
こそだて	子育て
ごぞんじ	ご存じ
ごぞんじ	ご存知
ごぞんじ	御存知
こたい	個体
こたい	固体
こだい	古代
こたいさ	個体差
こたえ	応え
こたえ	堪え
こたえ	答
こたえ	答え
こだか	小高
ごたく	御託
ごたしょう	ご多祥
ごたしょう	御多祥
こだち	木立
こたつ	炬燵
ごだつ	誤脱
ごたぼう	ご多忙
ごたぼう	御多忙
ごたようちゅう	ご多用中
ごたようちゅう	御多用中
こだわ	拘
ごだんかつよう	五段活用
こち	故知
こち	鯒
ごちそう	ご馳走
ごちそう	御馳走
こちゃく	固着
ごちゅうい	ご注意
ごちゅうい	御注意
ごちゅうもん	ご注文
ごちゅうもん	御注文
こちょう	胡蝶
こちょう	誇張
こちょう	蝴蝶
ごちょう	語調
こつ	骨
ごつうち	ご通知
ごつうち	御通知
こっか	国家
こっか	国歌
こっかい	国会
こっかい	黒海
こづかい	小遣い
こっかく	骨格
こっかん	酷寒
こっき	克己
こっき	国旗
こっきょう	国境
こっけい	滑稽
こっけん	国権
こっこ	国庫
こっこう	国交
ごつごう	ご都合
ごつごう	御都合
こっこうりつ	国公立
こっこく	刻々
こっし	骨子
こつずい	骨髄
こっせつ	骨折
こっちょう	骨頂
こつつぼ	骨壷
こづつみ	小包
こっとう	骨董
こつにく	骨肉
こっぱ	木端
こつばん	骨盤
こっぺん	骨片
こて	小手
こて	鏝
こてい	固定
こていよくき	固定翼機
こてき	鼓笛
こてさき	小手先
こてん	個展
こてん	古典
ごてん	御殿
こと	異
こと	琴
こと	古都
こと	事
こと	殊
ごと	毎
ことあげ	言挙げ
ことう	孤島
こどう	鼓動
ごとう	語頭
こどうぐ	小道具
ごどうさ	誤動作
ごとうちゃく	ご到着
ごとうちゃく	御到着
ことか	事欠
ことがら	事柄
ごとき	如き
こどく	孤独
ごとく	如く
ことこまか	事細か
ことさら	殊更
ことし	今年
ごとし	如し
ことたり	事足り
ことづけ	言付け
ことな	異な
ことに	異に
ことば	言葉
ことば	詞
ことぶき	寿
ことほ	祝
こども	子ども
こども	子供
ことり	小鳥
ことわ	断
ことわ	断わ
ことわざ	諺
こな	粉
こなごな	粉々
こにくらし	小憎らし
ごにん	誤認
こねあげ	こね上げ
こねまわ	こね回
この	好
この	此の
このあいだ	この間
このうえな	この上な
このうえな	この上無
このごろ	この頃
このさい	この際
このたび	この度
このまし	好まし
このみ	木の実
このもし	好もし
このよう	この様
このんで	好んで
こば	拒
ごはいりょ	ご配慮
ごはいりょ	御配慮
ごはさん	ご破算
ごはさん	御破算
こはぜ	鞐
ごはってん	ご発展
ごはってん	御発展
こばな	小鼻
こばなし	小話
こはる	小春
こはん	湖畔
こばん	小判
ごはん	ご飯
ごはん	御飯
ごばん	碁盤
ごはんえい	ご繁栄
ごはんえい	御繁栄
こばんざめ	小判鮫
ごはんじょう	ご繁盛
ごはんじょう	御繁盛
こはんとき	小半時
こび	媚び
ごび	語尾
こびと	小人
ごびゅう	誤謬
こびりつ	こびり付
こぶ	瘤
ごぶ	五分
こふう	古風
こふきいも	粉吹き芋
ごふく	呉服
ごぶさた	御無沙汰
こぶし	拳
こぶし	小節
こぶり	小降り
こふん	古墳
こぶん	古文
ごぶん	誤聞
ごへい	語弊
こべつ	個別
こべつ	戸別
ごへんかん	誤変換
ごへんじ	ご返事
ごへんじ	御返事
ごへんそう	ご返送
ごへんそう	御返送
ごべんたつ	御鞭撻
ごほう	誤報
ごほうこく	ご報告
ごほうこく	御報告
ごほうし	ご奉仕
ごほうし	ご芳志
ごほうし	御奉仕
ごほうし	御芳志
ごほうねん	ご放念
ごほうねん	御放念
ごほうめい	ご芳名
ごほうめい	御芳名
こぼれおち	こぼれ落ち
こま	駒
こま	困
ごま	胡麻
こまか	細か
ごまか	誤魔化
こまぎれ	細切れ
こまく	鼓膜
こましゃくれ	こまっしゃくれ
こまた	小股
こまつ	小松
ごまつ	語末
こまっちゃくれ	こまっしゃくれ
こまね	拱
こまやか	細やか
こまりはて	困り果て
こまわり	小回り
こみ	込
ごみ	塵
こみあ	込み合
こみあげ	こみ上げ
こみい	込み入
こみち	小道
こみち	小路
ごみばこ	ゴミ箱
こむぎ	小麦
こむぎこ	小麦粉
こむすび	小結
こむそう	虚無僧
こめ	込め
こめ	米
こめ	篭め
こめ	籠め
こめい	古名
ごめいわく	ご迷惑
ごめいわく	御迷惑
ごめん	御免
こも	篭
こも	籠
ごもく	五目
こもじ	小文字
こもち	子持
こもち	子持ち
こもの	小物
こもり	子守
こもん	顧問
こもん	小紋
こもんじょ	古文書
こや	小屋
こや	肥や
ごやく	誤訳
こやま	小山
こゆう	固有
こゆび	小指
こよい	今宵
こよう	雇用
ごよう	御用
ごよう	誤用
ごようおさめ	御用納め
ごようたつ	御用達
ごようはじめ	御用始め
ごようめい	ご用命
ごようめい	御用命
こよみ	暦
こら	凝ら
こら	懲ら
こらい	古来
ごらいこう	ご来光
ごらいこう	御来光
ごらいじょう	ご来場
ごらいじょう	御来場
ごらいてん	ご来店
ごらいてん	御来店
ごらいりん	ご来臨
ごらいりん	御来臨
こらえ	堪え
こらえしょう	堪え性
ごらく	娯楽
こらしめ	懲らしめ
ごらん	ご覧
ごらん	御覧
こり	懲り
こりー	コリー
ごりかい	ご理解
ごりかい	御理解
こりつ	孤立
ごりむちゅう	五里霧中
ごりやく	ご利益
ごりゅうせい	ご隆盛
ごりゅうせい	御隆盛
こりょ	顧慮
ごりよう	ご利用
ごりよう	御利用
ごりょうしょう	ご了承
ごりょうしょう	御了承
ごりょうしん	ご両親
ごりょうしん	御両親
こりょうり	小料理
ごりん	五輪
これいじょう	これ以上
これみよがし	これ見よがし
ごれんらく	ご連絡
ごれんらく	御連絡
ころ	頃
ころ	殺
ころ	転
ごろ	語呂
ころあい	頃合い
ころう	古老
ころが	転が
ころがりこ	転がり込
ごろく	語録
ころげこ	転げ込
ころしあ	殺し合
ごろね	ごろ寝
ころも	衣
ころもがえ	衣更え
こわ	壊
こわ	恐
こわ	怖
こわいろ	声色
こわね	声音
こわれ	壊れ
こん	根
こん	混
こん	紺
こんい	懇意
こんいん	婚姻
こんか	今夏
こんか	婚家
こんかい	今回
こんかん	根幹
こんがん	懇願
こんき	今期
こんき	婚期
こんき	根気
こんぎ	婚儀
こんきゃく	困却
こんきゅう	困窮
こんきょ	根拠
ごんぎょう	勤行
こんく	困苦
ごんげ	権化
こんけつ	混血
こんげつ	今月
こんげん	根源
こんご	今後
こんこう	混交
こんごう	根号
こんごう	混合
こんこん	渾々
こんさい	根菜
こんざい	混在
こんざつ	混雑
こんじ	今時
こんじ	根治
こんじき	金色
こんじゃく	今昔
こんしゅう	今秋
こんしゅう	今週
こんしゅん	今春
こんじょう	今生
こんじょう	懇情
こんじょう	根性
ごんじょう	言上
こんしん	懇親
こんしん	混信
こんしん	渾身
こんすい	昏睡
こんせい	懇請
こんせい	混成
こんせき	今夕
こんせき	痕跡
こんせつ	懇切
こんぜつ	根絶
こんせん	混戦
こんぜん	混然
こんぜん	渾然
こんだく	混濁
こんだく	溷濁
こんだて	献立
こんたん	魂胆
こんだん	懇談
こんち	根治
こんちゅう	昆虫
こんてい	根底
こんど	今度
こんどう	金堂
こんどう	混同
こんとん	混沌
こんなん	困難
こんにち	今日
こんにゃく	蒟蒻
こんにゅう	混入
こんねん	今年
こんねんど	今年度
こんぱい	困憊
こんぱく	魂魄
こんばん	今晩
こんぱん	今般
こんぶ	昆布
こんぺき	紺碧
こんぼう	懇望
こんぼう	混紡
こんぼう	棍棒
こんぽう	梱包
こんぽん	根本
こんめい	混迷
こんもう	懇望
こんもう	根毛
こんや	今夜
こんやく	婚約
こんよう	混用
こんらん	混乱
こんりゅう	建立
こんりゅう	根粒
こんりんざい	金輪際
こんれい	婚礼
こんわ	懇話
こんわ	混和
こんわく	困惑
さ	割
さ	去
さ	差
さ	鎖
さ	咲
さ	刺
さ	指
さ	射
さ	挿
さ	裂
ざ	座
さい	差異
さい	最
さい	際
ざい	材
ざい	罪
ざい	財
さいあい	最愛
さいあく	最悪
ざいあく	罪悪
ざいい	在位
さいう	最右
さいえん	再演
さいえん	才媛
さいえん	菜園
さいおうがうま	塞翁が馬
さいか	最下
さいか	裁可
ざいか	財貨
さいかい	再会
さいかい	再開
さいがい	災害
ざいかい	財界
ざいがい	在外
さいかく	才覚
ざいがく	在学
さいき	催奇
さいき	再帰
さいき	再起
さいき	才気
さいぎ	猜疑
さいきゅう	最急
さいきょう	最強
ざいきょう	在京
さいきん	最近
さいきん	細菌
ざいきん	在勤
さいく	細工
さいくつ	採掘
さいけい	再掲
ざいけい	財形
ざいけい	財経
さいけつ	採決
さいけつ	採血
さいけつ	裁決
さいげつ	歳月
さいけん	債券
さいけん	債権
さいけん	再建
さいげん	再現
さいげん	際限
ざいげん	財源
さいこ	最古
さいご	最期
さいご	最後
ざいこ	在庫
さいこう	再興
さいこう	再考
さいこう	最高
さいこう	採鉱
ざいこう	在校
ざいごう	在郷
さいこうさい	最高裁
さいこうちょう	最高潮
さいこうほう	最高峰
さいこく	催告
さいこん	再婚
さいさ	歳差
さいさん	再三
さいさん	採算
ざいさん	財産
さいし	妻子
さいじき	歳時記
さいじつ	祭日
ざいしつ	材質
さいしゅ	採取
さいしゅう	最終
さいしゅう	採集
ざいじゅう	在住
さいしゅうかい	最終回
さいしゅつ	歳出
さいしょ	最初
さいじょ	才女
ざいしょ	在所
さいしょう	最小
さいしょう	最少
さいじょう	最上
ざいじょう	罪状
さいしょうげん	最小限
さいしょうち	最小値
さいしょく	彩色
さいしょく	才色
さいしょく	菜食
ざいしょく	在職
さいしん	再審
さいしん	最新
さいしん	細心
さいすん	採寸
さいせい	再生
さいせい	再製
ざいせい	財政
さいせいき	最盛期
さいせき	採石
さいせき	砕石
ざいせき	在籍
さいせん	再選
さいぜん	最前
さいぜん	最善
さいぜんせん	最前線
さいせんたん	最先端
さいそう	再送
さいそく	催促
さいた	最多
さいたい	妻帯
さいだい	最大
さいだい	細大
さいだいげん	最大限
さいだいち	最大値
さいたく	採択
ざいたく	在宅
さいたん	最短
さいだん	祭壇
さいだん	裁断
ざいだん	財団
ざいだんほうじん	財団法人
さいち	才知
さいちゅう	最中
さいちょう	最長
さいてい	最低
さいてい	裁定
さいていげん	最低限
さいてき	最適
さいてん	採点
さいてん	祭典
さいど	再度
さいど	彩度
さいとうにゅう	再投入
さいどく	再読
さいな	苛
さいなん	災難
さいなんたん	最南端
ざいにち	在日
さいにゅう	歳入
さいにん	再任
ざいにん	在任
ざいにん	罪人
さいねん	再燃
さいねんしょう	最年少
さいねんちょう	最年長
さいのう	才能
さいはい	采配
さいばい	栽培
さいばし	才走
さいはつ	再発
ざいばつ	財閥
さいはん	再犯
さいはん	再販
さいばん	裁判
さいばんかん	裁判官
さいばんしょ	裁判所
さいひ	採否
さいひ	歳費
さいふ	財布
さいぶ	細部
さいぶん	細分
さいへん	再編
さいほう	裁縫
さいぼう	細胞
ざいほう	財宝
さいほくたん	最北端
さいまつ	歳末
さいみつ	細密
さいみん	催眠
さいみん	細民
さいむ	債務
ざいむ	財務
さいもく	細目
ざいもく	材木
さいゆうせん	最優先
さいよう	採用
さいらい	再来
ざいらい	在来
ざいりゅう	在留
さいりょう	最良
さいりょう	裁量
ざいりょう	材料
ざいりょく	財力
さいれい	祭礼
さいろく	採録
さいろく	載録
さいわい	幸
さいわい	幸い
さえ	冴え
さえき	差益
さえぎ	遮
さえつ	査閲
さお	竿
さお	棹
さか	坂
さか	盛
さが	下が
さが	性
さが	捜
さが	探
さかい	境
さかいめ	境目
さかえ	栄
さかえ	栄え
さかき	榊
さがく	差額
さかさ	逆さ
さがしあて	捜し当て
さがしだ	捜し出
さかずき	杯
さかだち	逆立
さかだち	逆立ち
さかづき	杯
さかて	逆手
さかな	魚
さかな	肴
さかのぼ	遡
さかば	酒場
さかま	逆巻
さかみち	坂道
さかむし	酒蒸
さかむし	酒蒸し
さかもり	酒盛り
さかや	酒屋
さから	逆ら
さかり	盛り
さかん	佐官
さかん	左官
さかん	盛ん
さき	左記
さき	先
さき	前
さぎ	詐欺
さぎ	鷺
ざき	崎
さきおくり	先送り
さきがけ	先駆け
さきごろ	先頃
さきざき	先々
さきさま	先様
さきだ	先立
さきだて	先立て
さきどり	先取り
さきばし	先走
さきほど	先程
さきまわり	先回り
さきもの	先物
さきゅう	砂丘
さきゆき	先行き
さぎょう	作業
さぎょうぎ	作業着
さきん	先ん
さく	作
さく	柵
さく	策
さく	索
さぐ	探
さくい	作意
さくい	作為
さくいおん	錯イオン
さくいん	索引
さくが	作画
さくがら	作柄
さくげん	削減
さくご	錯誤
さくし	作詞
さくし	策士
さくじ	作事
さくじ	作字
さくじつ	昨日
さくしゃ	作者
さくしゅ	搾取
さくじょ	削除
さくず	作図
さくせい	作成
さくせい	作製
さくせん	作戦
さくそう	錯綜
さくつけ	作付
さくてい	策定
さくてき	索敵
さくとう	昨冬
さくどう	策動
さくにゅう	搾乳
さくねん	昨年
さくねんど	昨年度
さくばん	昨晩
さくひょう	作表
さくひん	作品
さくふう	作風
さくぶん	作文
さくもつ	作物
さくや	昨夜
さくゆ	搾油
さくら	桜
さくら	櫻
さくらがい	桜貝
さくらもち	桜餅
さくらん	錯乱
さぐりあて	探り当て
さぐりだ	探り出
さくりゃく	策略
さくれい	作例
さくれつ	炸裂
ざくろ	石榴
さけ	叫
さけ	鮭
さけ	酒
さけ	避け
さげ	下げ
さげ	提げ
ざけ	酒
さけい	左傾
さけめ	裂け目
さげん	左舷
ざこう	座高
さこく	鎖国
ささ	笹
ささ	刺さ
ささい	些細
ささえ	支え
ささげ	捧げ
ささつ	査察
さざなみ	さざ波
さざなみ	漣
ささや	囁
ささら	簓
さざんか	山茶花
さじ	些事
さじ	匙
さしあげ	差し上げ
さしあた	差し当た
さしいれ	差し入れ
さしいれ	差入れ
さしえ	挿絵
さしおさえ	差し押え
さしおさえ	差し押さえ
さしおさえ	差押
さしおさえ	差押え
さしかえ	差し換え
さしかえ	差し替え
さしかえ	差換え
さしかえ	差替え
さしかけ	差しかけ
さしがね	差し金
さしがね	差金
さしき	挿し木
さじき	桟敷
ざしき	座敷
さしこ	差し込
さしさわ	差し障
さしさわり	差障り
さししめ	指し示
さしず	指図
さしせま	差し迫
さしだ	差し出
さしだしにん	差出人
さしつかえ	差し支え
さしでがまし	差し出がまし
さしとめ	差し止め
さしどめ	差止め
さしひ	差し引
さしひ	差引
さしひかえ	差し控え
さしひき	差引
さしまわ	差し回
さしみ	刺身
さしみず	差し水
さしみず	差水
さしむか	差し向か
さしむかい	差向い
さしむけ	差し向け
さしもど	差し戻
さしもどし	差戻し
さしゅ	詐取
さしゅう	査収
さしょう	些少
さしょう	査証
ざしょう	座礁
ざしょう	挫傷
さしわた	差し渡
さしわたし	差渡し
さじん	砂塵
さすが	流石
さずか	授か
さずけ	授け
ざせき	座席
させつ	左折
ざせつ	挫折
させん	左遷
させん	鎖線
ざぜん	坐禅
ざぜん	座禅
さそ	誘
さそいかけ	誘いかけ
さそいこ	誘い込
さそいだ	誘い出
ざぞう	座像
さそり	蠍
さそん	差損
さた	沙汰
ざた	沙汰
さだか	定か
さだま	定ま
さだめ	定め
さたん	左端
ざだん	座談
ざちょう	座長
さっ	察
さつ	冊
さつ	察
さつ	札
ざつ	雑
さつい	殺意
さつえい	撮影
ざつえき	雑益
ざつおん	雑音
さっか	作家
さっか	擦過
ざっか	雑貨
さつがい	殺害
さっかく	錯覚
ざつがく	雑学
さっき	殺気
さつき	五月
さつき	皐月
ざっき	雑記
さっきゅう	早急
ざっきょ	雑居
さっきょく	作曲
さっきん	殺菌
さっこん	昨今
さっし	冊子
さっし	察し
ざっし	雑誌
ざつじ	雑事
ざっしゅ	雑種
さっしょう	殺傷
ざっしょく	雑食
さっしん	刷新
さつじん	殺人
さつじんき	殺人鬼
さっすう	冊数
ざつぜん	雑然
さっそう	颯爽
ざっそう	雑草
さっそく	早速
ざった	雑多
ざつだん	雑談
さっち	察知
さっとう	殺到
ざっとう	雑踏
ざつねん	雑念
ざっぱい	雑俳
ざっぱく	雑駁
さつばつ	殺伐
さっぴ	さっ引
ざっぴ	雑費
ざつぶん	雑文
ざっぽう	雑報
さつまいも	薩摩芋
ざつむ	雑務
ざつよう	雑用
さつりく	殺戮
さてい	査定
さと	郷
さと	悟
さと	聡
さと	敏
さと	諭
さと	里
さとう	砂糖
さどう	作動
さどう	茶道
さどく	査読
さとめ	差し止め
さなぎ	蛹
さは	左派
さば	裁
さば	鯖
さば	捌
さはい	差配
さばく	砂漠
さはんじ	茶飯事
さび	錆
さび	錆び
さびし	寂し
さびし	淋し
さびつ	錆びつ
ざひょう	座標
さびれ	寂れ
ざぶとん	座蒲団
ざぶとん	座布団
さぶん	差分
さべつ	差別
さへん	左辺
さほう	作法
さぼう	砂防
さほど	然程
さま	覚ま
さま	様
さま	冷ま
さまがわり	様変り
さまがわり	様変わり
さまざま	様々
さまたげ	妨げ
さまつ	瑣末
さまよ	さ迷
さみし	寂し
さみし	淋し
さみだれ	五月雨
さむ	寒
さむえ	作務衣
さむけ	寒気
さむさ	寒さ
さむらい	侍
さめ	覚め
さめ	鮫
さめ	醒め
さめ	冷め
さめはだ	鮫肌
さもん	査問
さや	鞘
さやあて	鞘当て
ざやく	座薬
さゆう	左右
ざゆう	座右
さよう	作用
さよく	左翼
さら	拐
さら	皿
さら	晒
さら	曝
ざら	皿
さらいげつ	再来月
さらいしゅう	再来週
さらいねん	再来年
さらけだ	さらけ出
さらさら	更々
さらし	晒
さらに	更に
さる	猿
さる	申
さること	然ること
さるすべり	百日紅
さるぢえ	猿知恵
さるどし	申年
ざれごと	戯れ言
ざれぶみ	戯れ文
さわ	障
さわ	触
さわ	騒
さわ	沢
さわかい	茶話会
さわがし	騒がし
さわやか	爽やか
さわら	椹
さわら	鰆
さわん	左腕
さん	三
さん	参
さん	散
さん	産
さん	算
さん	賛
さん	酸
ざん	残
さんい	賛意
さんいつ	散逸
さんいん	参院
さんいん	産院
ざんえい	残映
さんか	傘下
さんか	参加
さんか	惨禍
さんか	讃歌
さんか	賛歌
さんか	酸化
さんが	参賀
さんが	山河
さんかい	参会
さんかい	散会
さんがい	三界
さんがい	惨害
ざんがい	残骸
さんかく	三角
さんかく	参画
さんがく	山岳
さんがく	産額
ざんがく	残額
さんかくちゅう	三角柱
さんかしゃ	参加者
さんがにち	三が日
さんがにち	三ヶ日
さんがにち	三箇日
さんかん	参観
さんかん	山間
さんかんしおん	三寒四温
ざんぎゃく	残虐
さんきゅう	産休
さんきょう	山峡
さんぎょう	産業
ざんきょう	残響
ざんぎょう	残業
ざんきん	残金
さんぐう	参宮
さんけ	産気
ざんげ	懺悔
さんけい	参詣
さんげき	惨劇
さんけん	三権
さんけん	散見
ざんげん	讒言
さんご	珊瑚
さんご	産後
さんこう	参考
ざんごう	塹壕
さんこうしょ	参考書
ざんこく	残酷
さんごしょう	珊瑚礁
さんこつ	散骨
さんさい	山菜
さんざい	散在
さんざい	散財
ざんさい	残滓
さんさく	散策
ざんさつ	惨殺
さんさん	燦々
さんざん	散々
さんし	蚕糸
さんじ	参事
さんじ	惨事
さんじ	産児
さんじ	賛辞
ざんし	残滓
ざんじ	暫時
さんじゅ	傘寿
さんしゅう	参集
さんじゅうく	三重苦
さんしゅつ	産出
さんしゅつ	算出
さんじゅつ	算術
さんじょ	賛助
ざんしょ	残暑
さんしょう	三唱
さんしょう	参照
さんじょう	参上
さんじょう	山上
さんじょう	惨状
ざんしょう	残照
さんしょううお	鯢
さんしょく	三食
さんしょく	蚕食
さんじょく	産褥
さんしん	三振
ざんしん	斬新
さんすい	撒水
さんすい	散水
さんすう	算数
さんせい	参政
さんせい	賛成
さんせい	酸性
さんせき	山積
ざんせつ	残雪
さんせん	参戦
さんぜん	燦然
さんせんそうもく	山川草木
さんそ	酸素
さんそう	山荘
ざんぞう	残像
さんぞく	山賊
さんそん	山村
ざんそん	残存
ざんぞん	残存
さんだい	産大
ざんだか	残高
さんだつ	簒奪
さんたん	惨澹
さんたん	賛嘆
さんだん	散弾
さんだん	算段
さんだんばら	三段腹
さんち	山地
さんち	産地
さんちゅう	山中
さんちょう	山頂
さんてい	算定
ざんてい	暫定
さんど	サンド
さんどう	参道
さんどう	賛同
さんにゅう	参入
さんにゅう	算入
さんにん	三人
ざんにん	残忍
さんにんしょう	三人称
ざんねん	残念
さんば	産婆
さんぱい	参拝
さんぱい	惨敗
ざんぱい	惨敗
さんばし	桟橋
さんぱつ	散発
さんぱつ	散髪
さんばん	三番
ざんぱん	残飯
さんび	賛美
さんぴ	賛否
さんびか	賛美歌
ざんぴん	残品
さんぷ	散布
さんぷ	産婦
ざんぶ	残部
さんぷく	山腹
さんふじんか	産婦人科
さんぶつ	産物
さんぶん	三分
さんぶん	散文
さんぽ	散歩
さんぼう	参謀
ざんぼう	讒謗
ざんまい	三昧
さんまん	散漫
さんみ	三位
さんみ	酸味
さんみゃく	山脈
ざんむ	残務
さんめんろっぴ	三面六臂
さんもんばん	三文判
さんゆ	産油
さんよ	参与
ざんよ	残余
さんよう	算用
さんようちゅう	三葉虫
さんらん	散乱
さんらん	産卵
さんりゅう	三流
ざんりゅう	残留
さんりん	山林
さんれつ	参列
さんろく	山麓
し	四
し	士
し	市
し	師
し	志
し	死
し	氏
し	至
し	詩
し	資
し	染
し	知
し	凍
し	敷
し	巳
じ	侍
じ	字
じ	持
じ	時
じ	痔
じ	辞
じ	地
しあい	試合
じあい	慈愛
じあい	自愛
しあが	仕上
しあが	仕上が
しあげ	仕上げ
じあげ	地上げ
しあわせ	幸せ
しあん	思案
しあん	私案
しい	強い
しい	四囲
しい	思惟
しい	私意
しい	椎
しい	恣意
じい	自慰
じい	辞意
じい	爺
しいか	詩歌
しいく	飼育
じいしき	自意識
しいたけ	椎茸
しいたげ	虐げ
しいれ	仕入れ
しいん	子音
しいん	死因
しいん	試飲
じいん	寺院
しうち	仕打
しうんてん	試運転
しえい	市営
しえい	私営
じえい	自営
じえい	自衛
しえき	使役
しえき	私益
じぇっとき	ジェット機
しえん	支援
しえん	私怨
しえん	紫煙
じえん	自演
しお	塩
しお	汐
しお	潮
しおから	塩辛
しおくり	仕送り
しおけ	塩気
しおづけ	塩漬け
しおひがり	潮干狩
しおみず	塩水
しおやき	塩焼
しおり	栞
しおん	紫苑
しか	市価
しか	歯科
しか	鹿
しか	叱
じか	時下
じか	時価
じか	自家
じが	自我
じが	自画
しかい	司会
しかい	市会
しかい	視界
しかい	歯科医
しがい	市外
しがい	市街
しがい	死骸
じかい	次回
しがいせん	紫外線
しかえし	仕返し
しかく	四角
しかく	死角
しかく	視覚
しかく	資格
しがく	史学
しがく	志学
しがく	私学
しがく	歯学
じかく	字画
じかく	自覚
じがく	自学
しかけ	仕掛
しかけ	仕掛け
じかせい	自家製
じがぞう	自画像
しかた	仕方
しかたな	仕方な
じがため	地固め
じかつ	自活
しかばね	屍
じかよう	自家用
じかようしゃ	自家用車
しかり	然り
しかりつけ	叱りつけ
しかるべき	然るべき
しかん	仕官
しかん	士官
しかん	弛緩
しがん	志願
じかん	時間
じかん	次官
じかんがい	時間外
じかんぎれ	時間切れ
じかんたい	時間帯
じかんわり	時間割
しき	仕切
しき	四季
しき	始期
しき	指揮
しき	死期
しき	式
しぎ	仕儀
しぎ	市議
しぎ	鴫
じき	時期
じき	時機
じき	次期
じき	磁器
じき	磁気
じき	自棄
じぎ	字義
じぎ	辞儀
しきい	敷居
しきいき	識閾
しきいち	しきい値
しききん	敷金
しきさい	色彩
じきさん	直参
しきし	色紙
しきじ	式辞
じきじき	直々
しきしゃ	識者
しきじょう	式場
しきそ	色素
じきそ	直訴
しきそう	色相
しきち	敷地
しきちょう	色調
しきつめ	敷き詰め
しきてん	式典
じきひつ	直筆
しきふ	敷布
しきぶ	式部
しきべつ	識別
しきもう	色盲
しぎやき	鴫焼き
しぎゃく	嗜虐
じぎゃく	自虐
しきゅう	子宮
しきゅう	支給
しきゅう	至急
じきゅう	持久
じきゅう	時給
じきゅう	自給
しきょ	死去
じきょ	辞去
しきょう	司教
しきょう	市況
しぎょう	始業
じきょう	自供
じぎょう	事業
じぎょうしょ	事業所
じぎょうぬし	事業主
しきょうひん	試供品
じぎょうぶ	事業部
しきょく	支局
じきょく	時局
じきょく	磁極
しきり	仕切り
しきん	至近
しきん	資金
しぎん	詩吟
しきんぐり	資金繰り
しく	仕組
しく	市区
じく	字句
じく	軸
じくう	時空
しぐさ	仕草
じくじ	忸怩
しくはっく	四苦八苦
しぐれ	時雨
しげ	繁
しげ	茂
しけい	死刑
しけい	私刑
じけい	次兄
しげき	刺激
しけつ	止血
じけつ	自決
しげみ	茂み
しけん	私見
しけん	試験
しげん	至言
しげん	資源
じけん	事件
じげん	時限
じげん	次元
しけんかん	試験管
しけんじょう	試験場
しけんへん	試験片
しこ	仕込
しご	扱
しご	死後
しご	死語
しご	私語
じこ	事故
じこ	自己
じご	事後
しこう	志向
しこう	思考
しこう	指向
しこう	施行
しこう	至高
しこう	試行
しこう	歯垢
しこう	嗜好
じこう	事項
じこう	時候
じこう	時効
じこう	次項
じごう	次号
じごうじとく	自業自得
しごく	至極
じこく	時刻
じこく	自国
じごく	地獄
しごと	仕事
しこん	紫紺
しこん	歯根
しさ	示唆
じさ	時差
しさい	司祭
しさい	子細
しざい	私財
しざい	資材
じざい	自在
しさく	思索
しさく	施策
しさく	試作
じさく	自作
じさげ	字下げ
じざけ	地酒
しさつ	刺殺
しさつ	視察
じさつ	自殺
しさん	四散
しさん	試算
しさん	資産
じさん	持参
じさん	自賛
しし	四肢
しし	獅子
しじ	師事
しじ	指示
しじ	支持
しじ	私事
じし	次子
じじ	時事
じじ	爺
じじこくこく	時々刻々
ししつ	資質
じしつ	自失
じしつ	自室
じじつ	事実
じじつじょう	事実上
ししまい	獅子舞
しじみ	蜆
ししゃ	使者
ししゃ	支社
ししゃ	死者
ししゃ	試写
ししゃ	試射
じしゃ	寺社
じしゃ	自社
ししゃく	子爵
じしゃく	磁石
じじゃく	自若
ししゃごにゅう	四捨五入
ししゃちょう	支社長
ししゅ	死守
じしゅ	字種
じしゅ	自主
じしゅ	自首
ししゅう	刺繍
ししゅう	屍臭
ししゅう	詩集
しじゅう	四重
しじゅう	始終
じしゅう	自習
じじゅう	侍従
じじゅう	自重
しじゅうから	四十雀
ししゅうき	思秋期
しじゅうそう	四重奏
しじゅく	私塾
じしゅく	自粛
ししゅつ	支出
しじゅん	示準
じじゅん	耳順
ししゅんき	思春期
ししょ	司書
ししょ	支所
ししょ	支署
しじょ	子女
じしょ	自署
じしょ	辞書
じしょ	地所
じじょ	次女
じじょ	自序
ししょう	刺傷
ししょう	師匠
ししょう	支障
ししょう	死傷
しじょう	史上
しじょう	市場
しじょう	私情
しじょう	紙上
しじょう	至上
しじょう	試乗
しじょう	誌上
じしょう	事象
じしょう	次章
じしょう	自称
じじょう	事情
じじょう	自乗
じじょうじばく	自縄自縛
ししょく	試食
じしょく	辞職
じじょでん	自叙伝
ししょばこ	私書箱
ししん	指針
ししん	私信
ししん	私心
ししん	視診
しじん	詩人
じしん	磁針
じしん	自信
じしん	自身
じしん	地震
じしんは	地震波
しず	沈
じすい	自炊
しすう	指数
じすう	字数
じすう	次数
しずか	静か
しずく	雫
しずく	滴
しずけさ	静けさ
しずま	静ま
しずま	鎮ま
しずまりかえ	静まり返
しずめ	静め
しずめ	沈め
しずめ	鎮め
しせい	姿勢
しせい	市井
しせい	市制
しせい	市政
しせい	施政
しせい	私製
じせい	時世
じせい	時制
じせい	時勢
じせい	自制
しせいかつ	私生活
しせいかん	死生観
しせいじ	私生児
しせき	史跡
しせき	歯石
じせき	次席
じせき	自席
じせき	自責
しせつ	使節
しせつ	施設
しせつ	私設
じせつ	時節
じせつ	自説
しせる	死せる
しせん	支線
しせん	死線
しせん	視線
しぜん	自然
じせん	自薦
じせん	自選
じぜん	事前
じぜん	慈善
じぜん	次善
しそ	紫蘇
しそう	思想
しそう	試走
しぞう	死蔵
じぞう	地蔵
しそうか	思想家
しそく	四則
しそく	子息
しぞく	士族
しぞく	氏族
じそく	時速
じぞく	持続
しそん	子孫
じそん	自存
じそん	自尊
した	下
した	舌
した	慕
じた	自他
じだ	耳朶
したい	姿態
したい	死体
したい	肢体
しだい	私大
しだい	次第
じたい	事態
じたい	字体
じたい	自体
じたい	辞退
じだい	時代
じだい	次代
じだい	地代
じだいげき	時代劇
じだいしゅぎ	事大主義
したうけ	下請け
したえ	下絵
したが	従
したがき	下書き
したがって	従って
したぎ	下着
したく	支度
じたく	自宅
したざわり	舌触り
したし	親し
したじ	下地
しだし	仕出し
したじき	下敷
したしらべ	下調べ
したた	滴
したたか	強か
したため	認め
したたらず	舌足らず
したっぱ	下っ端
したづみ	下積み
したて	下手
したて	仕立て
したどり	下取り
したね	下値
したばたらき	下働き
したび	下火
したまち	下町
したまわ	下回
したみ	下見
したむき	下向き
じだらく	自堕落
しだれ	垂れ
したわし	慕わし
しだん	師団
しだん	指弾
じたん	時短
じだん	次段
じだん	示談
しち	七
しち	質
じち	自治
じちかい	自治会
しちぐさ	質草
しちけん	質権
しちしょう	七生
じちたい	自治体
しちてんばっとう	七転八倒
しちなん	七難
しちめんどう	しち面倒
しちや	質屋
しちゅう	市中
しちゅう	支柱
しちょう	市長
しちょう	思潮
しちょう	支庁
しちょう	視聴
しちょう	試聴
しちよう	七曜
じちょう	次長
じちょう	自重
じちょう	自嘲
しちょうそん	市町村
しちょく	司直
しつ	室
しつ	質
じつ	実
しつい	失意
じついん	実印
しつう	止痛
じつえき	実益
じつえん	実演
しつおん	室温
しっか	失火
じっか	実家
しつがい	室外
じつがい	実害
しっかく	失格
しっかん	疾患
しつかん	質感
じっかん	実感
じっかん	十干
しっき	漆器
しつぎ	質疑
じっき	実機
じつぎ	実技
しっきゃく	失脚
しつぎょう	失業
じっきょう	実況
じつぎょう	実業
じつぎょうか	実業家
しっきん	失禁
しっけ	湿気
しつけ	仕付け
しつけ	躾
しつけ	躾け
しっけい	失敬
じっけい	実刑
じっけい	実兄
しっけん	失権
しつげん	失言
しつげん	湿原
じっけん	実検
じっけん	実権
じっけん	実験
じつげん	実現
しっこう	執行
しっこう	失効
じっこう	実効
じっこう	実行
しっこく	桎梏
しつごしょう	失語症
じっこん	実根
じっこん	昵懇
じっさい	実際
じつざい	実在
しっさく	失策
じっさく	実作
しつじ	執事
じっし	実子
じっし	実施
じっし	実視
しつじつ	質実
じっしつ	実質
じっしゃ	実写
じっしゃかい	実社会
じっしゅう	実収
じっしゅう	実習
しつじゅん	湿潤
しっしょう	失笑
じっしょう	実証
じつじょう	実情
じつじょう	実状
しっしょく	失職
しっしん	失神
しっしん	湿疹
じっすう	実数
しっせい	失政
じっせい	実勢
じっせいかつ	実生活
しっせき	叱責
じっせき	実績
じっせん	実戦
じっせん	実線
じっせん	実践
しっそ	質素
しっそう	失踪
しっそう	疾走
じっそう	実装
じつぞう	実像
しっそく	失速
じっそく	実測
じつぞん	実存
しった	叱咤
しったい	失態
じったい	実体
じったい	実態
じつだん	実弾
しっち	湿地
じっち	実地
しっちょう	失調
しつちょう	室長
じっちょく	実直
しっつい	失墜
しつてき	質的
しってん	失点
しつでん	湿田
しっと	嫉妬
しつど	湿度
しっとう	執刀
じつどう	実働
しつない	室内
しつないがく	室内楽
しつねん	失念
しっぱい	失敗
じっぴ	実費
しっぴつ	執筆
しっぴつしゃ	執筆者
しっぷ	湿布
じっぷ	実父
しっぷう	疾風
じつぶつ	実物
しっぺい	疾病
しっぽ	尻尾
じつぼ	実母
しつぼう	失望
しつむ	執務
じつむ	実務
しつめい	失明
じつめい	実名
しつもん	質問
しつよう	執よう
しつよう	執拗
じつよう	実用
じづら	字面
じつり	実利
しつりょう	質量
じつりょく	実力
しつれい	失礼
じつれい	実例
しつれん	失恋
じつろく	実録
じつわ	実話
してい	師弟
してい	指定
してい	私邸
してい	視程
していせき	指定席
してき	史的
してき	指摘
してき	私的
してき	至適
してき	詩的
じてき	自適
してつ	私鉄
してん	始点
してん	支店
してん	支点
してん	視点
しでん	市電
じてん	事典
じてん	時点
じてん	次点
じてん	自転
じてん	辞典
じでん	自伝
じてんしゃ	自転車
してんちょう	支店長
してんのう	四天王
しと	使徒
しと	使途
しとう	死闘
しどう	始動
しどう	指導
しどう	私道
じとう	自答
じどう	児童
じどう	自動
じどうし	自動詞
じどうしゃ	自動車
じどうしゃどう	自動車道
じとく	自得
しとみ	蔀
しな	品
しない	市内
しない	竹刀
しなお	し直
しなかず	品数
しなぎれ	品切れ
しなさだめ	品定め
しなじな	品々
しなび	萎び
しなもの	品物
じなり	地鳴り
しなん	指南
しなん	至難
じなん	次男
しなんばん	指南番
しにせ	老舗
しにたえ	死に絶え
しにはて	死に果て
しにょう	し尿
しにん	死人
しにん	視認
じにん	自任
じにん	自認
じにん	辞任
じぬし	地主
しね	死ね
じねつ	地熱
しねん	思念
しの	篠
しの	偲
しの	忍
しの	凌
しのびこ	忍び込
しのびよ	忍び寄
しのぶ	忍
しば	柴
しば	芝
しば	縛
じば	地場
しはい	支配
しはい	紙背
しはい	賜杯
しばい	芝居
しはいにん	支配人
じはく	自白
じばく	自爆
じばくれい	地縛霊
しばし	暫し
じはだ	地肌
しはつ	始発
じはつ	自発
しばづけ	柴漬け
しばふ	芝生
しはらい	支払
しはらいにん	支払人
しばらく	暫く
しばりつけ	縛り付け
しはん	市販
しはん	師範
しはん	死斑
じばん	地盤
しはんき	四半期
じはんき	自販機
しはんだい	師範代
しひ	市費
じひ	慈悲
じひ	自費
じびか	耳鼻科
じびき	字引
じひつ	自筆
しびと	死人
しひょう	指標
じひょう	辞表
じびょう	持病
しびれ	痺れ
しぶ	市部
しぶ	支部
しぶ	渋
じふ	自負
しぶがき	渋柿
しぶかわ	渋皮
しふく	私服
しふく	私腹
しふく	至福
しふく	雌伏
しぶしぶ	渋々
しぶつ	私物
じぶつ	事物
しふん	私憤
しふん	脂粉
しぶん	詩文
じぶん	時分
じぶん	自分
しぶんぎ	四分儀
しべ	蕊
しへい	紙幣
じへいしょう	自閉症
しべつ	死別
しべん	思弁
しべん	至便
じへん	事変
しぼ	萎
しぼ	絞
しぼ	搾
しぼ	思慕
しほう	司法
しほう	四方
しほう	至宝
しぼう	志望
しぼう	死亡
しぼう	脂肪
じほう	時報
じぼう	自暴
しぼうこう	志望校
しぼうさん	脂肪酸
しほうしょし	司法書士
しぼつ	死没
しぼりあげ	絞り上げ
しぼりあげ	搾り上げ
しぼりだ	絞り出
しほん	資本
しほんか	資本家
しほんきん	資本金
しま	仕舞
しま	縞
しま	締ま
しま	島
しま	閉ま
じま	島
しまい	姉妹
しまい	終い
じまえ	自前
しまかげ	島陰
じまく	字幕
しまぐに	島国
しまつ	始末
じまん	自慢
しみ	紙魚
しみ	浸み
しみ	染み
しみ	凍み
じみ	地味
しみこ	染み込
しみず	清水
じみち	地道
しみつ	染み着
しみつ	染み付
しみどうふ	凍み豆腐
しみぬき	染み抜き
しみゃく	支脈
しみょう	至妙
しみん	市民
しみんぜい	市民税
じむ	事務
じむき	事務機
じむきょく	事務局
しむけ	仕向
しむけ	仕向け
じむしょ	事務所
しめ	絞め
しめ	示
しめ	湿
しめ	占め
しめ	締
しめ	締め
しめ	閉め
しめい	使命
しめい	指名
しめい	指命
しめい	氏名
じめい	自明
しめき	締め切
しめき	閉め切
しめきり	〆切
しめきり	〆切り
しめきり	締切
しめきり	締切り
しめきりび	締切日
しめくく	締めくく
しめし	示し
しめだ	締め出
しめつ	死滅
じめつ	自滅
しめつけ	締めつけ
しめつけ	締め付け
しめっぽ	湿っぽ
しめて	締めて
しめび	締め日
しめび	締日
しめん	紙面
しめん	誌面
じめん	地面
しめんそか	四面楚歌
しめんたい	四面体
しも	下
しも	霜
しもがれ	霜枯れ
しもき	下期
じもく	耳目
しもざ	下座
しもじも	下々
しもつき	霜月
しもて	下手
じもと	地元
しもばしら	霜柱
しもはんき	下半期
しもべ	僕
しもやけ	霜焼け
しもん	指紋
しもん	試問
しもん	諮問
じもん	自問
しゃ	社
しゃ	紗
しゃ	謝
しゃ	車
しや	視野
じゃ	蛇
じゃあく	邪悪
しゃい	謝意
しゃいん	社員
しゃうん	社運
しゃえい	射影
しゃおく	社屋
しゃおん	謝恩
しゃおん	遮音
しゃか	釈迦
しゃかい	社会
しゃがい	社外
しゃがいひ	社外秘
じゃき	邪気
しゃきょう	写経
しゃぎょう	社業
しゃく	勺
しゃく	尺
しゃく	杓
しゃく	酌
しゃく	癪
しやく	試薬
じゃく	寂
じゃく	弱
しゃくい	爵位
しゃくざい	借財
しゃくし	杓子
じゃくし	弱視
しゃくじい	石神井
しゃくしじょうぎ	杓子定規
じゃくしゃ	弱者
しやくしょ	市役所
しゃくじょう	錫杖
じゃくしょう	弱小
じゃくしん	弱震
しゃくぜん	釈然
しゃくち	借地
じゃぐち	蛇口
じゃくてん	弱点
しゃくど	尺度
しゃくとりむし	尺取虫
じゃくにくきょうしょく	弱肉強食
しゃくねつ	灼熱
じゃくねん	若年
じゃくはい	若輩
しゃくはち	尺八
しゃくほう	釈放
しゃくめい	釈明
しゃくやく	芍薬
じゃくやく	雀躍
しゃくよう	借用
じゃくら	雀羅
しゃくりょう	酌量
しゃけ	鮭
しゃげき	射撃
しゃけん	車検
じゃけん	邪慳
しゃこ	車庫
しゃこう	斜交
しゃこう	斜行
しゃこう	社交
しゃこう	車高
しゃこう	遮光
しゃさい	社債
しゃさい	車載
しゃざい	謝罪
しゃさつ	射殺
しゃし	斜視
しゃし	社史
しゃし	奢侈
しゃじ	社寺
しゃじ	謝辞
しゃじく	車軸
しゃじつ	写実
じゃじゃうま	じゃじゃ馬
しゃしゅ	車種
しゃしゅつ	射出
しゃしょう	捨象
しゃしょう	車掌
しゃじょう	謝状
しゃしょく	写植
しゃしん	写真
じゃしん	邪心
じゃすい	邪推
しゃせい	写生
しゃせい	射精
しゃせつ	社説
しゃぜつ	謝絶
しゃせん	斜線
しゃせん	車線
しゃそう	社葬
しゃそう	車窓
しゃぞう	写像
しゃそく	車速
しゃたい	斜体
しゃたい	車体
しゃたく	社宅
しゃだん	社団
しゃだん	遮断
しゃだんき	遮断器
しゃだんほうじん	社団法人
しゃち	鯱
しゃちゅう	社中
しゃちゅう	車中
しゃちょう	社長
しゃつ	シャツ
しゃっかん	借款
じゃっかん	若干
じゃっき	惹起
しゃっきん	借金
じゃっく	惹句
しゃっけい	借景
しゃっこう	赤口
しゃてい	舎弟
しゃてい	射程
しゃてき	射的
しゃどう	車道
じゃどう	邪道
しゃない	社内
しゃない	車内
しゃにくさい	謝肉祭
しゃにむに	遮二無二に
じゃのめ	蛇の目
しゃひ	社費
しゃふ	写譜
しゃふう	社風
しゃふつ	煮沸
しゃべ	喋
しゃへい	遮蔽
しゃへん	斜辺
じゃま	邪魔
しゃみ	沙弥
しゃみ	三味
しゃみせん	三味線
しゃめい	社名
しゃめん	斜面
しゃよう	社用
じゃり	砂利
しゃりょう	車両
しゃりん	車輪
しゃれ	洒落
しゃれい	謝礼
しゃれき	社歴
じゃんそう	雀荘
しゅ	主
しゅ	朱
しゅ	種
しゅい	主意
しゅい	趣意
しゅい	首位
しゅいん	主因
しゅう	周
しゅう	州
しゅう	洲
しゅう	秀
しゅう	週
しゅう	集
しゆう	私有
しゆう	雌雄
じゅう	拾
じゅう	十
じゅう	重
じゅう	銃
じゅう	中
じゆう	事由
じゆう	自由
じゅうあつ	重圧
しゅうい	周囲
しゅうい	拾遺
じゅうい	獣医
しゅういつ	秀逸
しゅういん	衆院
しゅうう	驟雨
しゅうえき	収益
しゅうえき	就役
しゅうえん	終焉
じゅうおう	縦横
しゅうか	集荷
しゅうかい	周回
しゅうかい	集会
しゅうかく	収穫
しゅうがく	就学
しゅうがく	修学
しゅうかん	習慣
しゅうかん	週刊
しゅうかん	週間
じゅうかん	獣姦
じゅうかん	縦貫
じゅうかん	重患
じゅうがん	銃眼
しゅうかんし	週刊誌
しゅうき	周忌
しゅうき	周期
しゅうき	終期
しゅうぎ	祝儀
じゅうき	什器
じゅうき	銃器
しゅうきゅう	蹴球
しゅうきゅう	週休
しゅうきゅう	週給
じゅうきょ	住居
しゅうきょう	宗教
しゅうぎょう	就業
しゅうぎょう	修業
しゅうぎょう	終業
じゆうぎょう	自由業
じゅうぎょういん	従業員
しゅうきょうほうじん	宗教法人
しゅうきょく	終局
しゅうきょく	終曲
しゅうきょく	褶曲
しゅうきん	集金
じゅうきんぞく	重金属
しゅうけい	集計
じゅうけい	重刑
じゅうけいしょう	重軽傷
しゅうげき	襲撃
じゅうげき	銃撃
しゅうけつ	終結
しゅうけつ	集結
じゅうけつ	充血
しゅうけん	集権
しゅうげん	祝言
しゅうこう	周航
しゅうこう	就航
しゅうこう	修好
しゅうこう	醜行
しゅうごう	集合
じゅうこう	重厚
じゅうこう	重工
じゅうこう	銃口
じゅうこうぎょう	重工業
じゅうこん	重婚
しゅうさい	収載
しゅうさい	秀才
じゅうざい	重罪
しゅうさく	秀作
しゅうさく	習作
じゅうさつ	銃殺
しゅうさん	衆参
しゅうさん	集散
しゅうさん	蓚酸
しゅうし	収支
しゅうし	宗旨
しゅうし	修士
しゅうし	終始
しゅうし	終止
しゅうじ	修辞
しゅうじ	習字
じゅうし	重視
じゅうじ	十字
じゅうじ	十時
じゅうじ	従事
しゅうじつ	終日
じゅうじつ	充実
しゅうしゅう	収拾
しゅうしゅう	収集
しゅうしゅう	蒐集
じゅうじゅう	重々
しゅうしゅく	収縮
しゅうじゅく	習熟
じゅうじゅん	従順
じゅうしょ	住所
しゅうしょう	周章
しゅうしょう	愁傷
じゅうしょう	重傷
じゅうしょう	重唱
じゅうしょう	重症
じゅうしょう	重賞
じゅうじょう	重畳
しゅうしょく	就職
しゅうしょく	修飾
じゅうしょく	住職
しゅうしょくし	修飾子
しゅうじょし	終助詞
じゅうしょろく	住所録
しゅうしん	執心
しゅうしん	就寝
しゅうしん	終身
しゅうじん	囚人
しゅうじん	衆人
じゅうしん	重心
じゅうしん	銃身
じゅうすい	重水
しゅうせい	修整
しゅうせい	修正
しゅうせい	終生
しゅうせい	習性
しゅうせい	集成
じゅうせい	銃声
じゅうぜい	重税
しゅうせき	集積
じゅうせき	重責
しゅうせん	周旋
しゅうせん	終戦
しゅうぜん	修繕
じゅうぜん	十全
じゅうぜん	従前
しゅうそ	愁訴
しゅうそ	臭素
じゅうそう	縦走
じゅうそう	重奏
じゅうそう	重曹
しゅうそく	収束
しゅうそく	終息
しゅうそく	集束
しゅうぞく	習俗
じゅうそく	充足
じゅうぞく	従属
しゅうたい	醜態
じゅうたい	渋滞
じゅうたい	重体
じゅうだい	重大
しゅうたいせい	集大成
じゅうたく	住宅
じゅうたくがい	住宅街
じゅうたくち	住宅地
しゅうたん	愁嘆
しゅうたん	終端
しゅうだん	集団
じゅうたん	絨毯
じゅうだん	縦断
じゅうだん	銃弾
しゅうち	周知
しゅうち	習知
しゅうち	羞恥
しゆうち	私有地
しゅうちく	修築
しゅうちゃく	執着
しゅうちゃく	終着
しゅうちゅう	集中
しゅうちょう	酋長
しゅうてん	終点
しゅうでん	終電
じゅうてん	充填
じゅうてん	重点
じゅうでん	充電
しゅうと	姑
しゅうとう	周到
しゅうどう	修道
じゅうとう	充当
じゅうどう	柔道
しゅうとく	収得
しゅうとく	修得
しゅうとく	拾得
しゅうとく	習得
しゅうとめ	姑
じゅうなん	柔軟
じゅうにし	十二支
じゅうにしちょう	十二指腸
しゅうにゅう	収入
しゅうにん	就任
じゅうにん	住人
しゅうねん	執念
しゅうねん	周年
しゅうのう	収納
しゅうは	周波
しゅうは	宗派
しゅうは	秋波
しゅうはい	集配
じゅうばこ	重箱
しゅうばす	終バス
しゅうはすう	周波数
しゅうばつ	秀抜
じゅうばつ	重罰
しゅうばん	終盤
じゅうはん	重版
じゅうびょう	重病
しゅうふく	修復
じゅうふく	重複
しゅうぶん	秋分
しゅうぶん	醜聞
じゅうぶん	充分
じゅうぶん	十分
しゅうへき	習癖
しゅうへん	周辺
しゅうほう	週報
しゅうぼう	衆望
しゅうぼう	醜貌
じゅうほう	銃砲
じゅうぼく	従僕
しゅうまい	焼売
しゅうまく	終幕
しゅうまつ	終末
しゅうまつ	週末
じゅうまん	充満
しゅうみん	就眠
じゅうみん	住民
じゅうみんか	住民課
じゅうみんぜい	住民税
しゅうめい	襲名
じゅうめん	渋面
じゅうもう	絨毛
しゅうもく	衆目
じゅうもんじ	十文字
しゅうや	終夜
しゅうやく	集約
じゅうやく	重役
じゅうゆ	重油
しゅうゆう	周遊
しゅうよう	収容
しゅうよう	収用
しゅうよう	修養
じゅうよう	充用
じゅうよう	重要
じゅうようし	重要視
しゅうらい	襲来
じゅうらい	従来
しゅうらく	集落
じゅうらん	縦覧
しゅうり	修理
しゅうりょう	収量
しゅうりょう	修了
しゅうりょう	終了
じゅうりょう	重量
じゅうりょうあげ	重量挙げ
しゅうりょうご	終了後
じゅうりょうぜい	従量税
じゅうりょく	重力
しゅうりん	秋霖
じゅうりん	蹂躙
しゅうれい	秋冷
じゅうれつ	縦列
しゅうれん	収斂
しゅうれん	修練
しゅうろう	就労
しゅうろく	収録
しゅうろく	集録
しゅうろん	修論
しゅうわい	収賄
しゅえい	守衛
しゅえん	主演
しゅかい	主魁
じゅかい	樹海
しゅかく	主格
しゅかん	主幹
しゅかん	主観
しゅがん	主眼
しゅき	手記
しゅぎ	主義
じゅきゅう	受給
じゅきゅう	需給
しゅきゅうは	守旧派
しゅぎょう	修行
じゅぎょう	授業
しゅく	宿
しゅく	祝
じゅく	宿
じゅく	塾
じゅく	熟
しゅくい	祝意
しゅくえん	祝宴
しゅくが	祝賀
しゅくがん	宿願
しゅくぎ	祝儀
じゅくご	熟語
じゅくこう	熟考
しゅくさつ	縮刷
しゅくじ	祝辞
じゅくし	熟柿
じゅくじくん	熟字訓
しゅくじつ	祝日
しゅくしゃ	宿舎
しゅくしゃ	縮写
しゅくしゃく	縮尺
しゅくしゅく	粛々
しゅくじょ	淑女
しゅくしょう	祝勝
しゅくしょう	縮小
しゅくず	縮図
じゅくすい	熟睡
しゅくせい	粛正
しゅくせい	粛清
じゅくせい	熟成
しゅくぜん	粛然
しゅくたい	縮退
しゅくだい	宿題
じゅくたつ	熟達
じゅくち	熟知
しゅくちょく	宿直
しゅくてき	宿敵
しゅくてん	祝典
しゅくでん	祝電
じゅくどく	熟読
じゅくねん	熟年
しゅくば	宿場
しゅくはい	祝杯
しゅくはく	宿泊
しゅくふく	祝福
しゅくほう	祝砲
しゅくぼう	宿望
しゅくめい	宿命
しゅくやく	縮約
じゅくりょ	熟慮
じゅくれん	熟練
しゅくん	主君
しゅくん	殊勲
しゅけい	主計
しゅげい	手芸
じゅけい	受刑
しゅけん	主権
じゅけん	受検
じゅけん	受験
じゅけんせい	受験生
しゅご	主語
しゅご	守護
しゅこう	趣向
しゅこう	酒肴
じゅこう	受講
しゅごしん	守護神
しゅさ	主査
しゅさい	主催
しゅさい	主宰
しゅさい	主菜
しゅざい	取材
しゅさん	主餐
しゅざん	珠算
じゅさん	授産
しゅし	主旨
しゅし	種子
しゅし	趣旨
しゅじ	主事
しゅじ	主辞
じゅし	樹脂
しゅじい	主治医
しゅじく	主軸
しゅしゃ	取捨
しゅしゃせんたく	取捨選択
しゅじゅ	種々
じゅじゅ	授受
しゅじゅう	主従
しゅじゅつ	主述
しゅじゅつ	手術
じゅじゅつ	呪術
しゅしょう	主唱
しゅしょう	主将
しゅしょう	殊勝
しゅしょう	首相
しゅじょう	衆生
じゅしょう	受賞
じゅしょう	授賞
しゅしょく	主食
しゅしん	主審
しゅじん	主人
じゅしん	受信
じゅしん	受診
しゅじんこう	主人公
じゅず	数珠
しゅすい	取水
じゅすい	入水
しゅせい	守勢
じゅせい	受精
じゅせい	授精
しゅぜいほう	酒税法
しゅせき	主席
しゅせき	首席
しゅせきさん	酒石酸
しゅぞう	酒造
じゅぞう	受像
しゅぞく	種族
しゅたい	主体
しゅだい	主題
じゅたい	受胎
じゅたく	受託
じゅだく	受諾
しゅだん	手段
しゅちにくりん	酒池肉林
しゅちゅう	手中
じゅちゅう	受注
しゅちょう	主張
しゅちょう	主潮
しゅちょう	首長
しゅつ	出
じゅつ	術
しゅつえん	出演
しゅっか	出火
しゅっか	出荷
じゅっかい	述懐
しゅっかん	出棺
しゅつがん	出願
しゅっきん	出勤
しゅっきん	出金
しゅつげき	出撃
しゅっけつ	出欠
しゅっけつ	出血
しゅつげん	出現
しゅっこ	出庫
じゅつご	術語
じゅつご	述語
しゅっこう	出向
しゅっこう	出稿
しゅっこう	出航
しゅっこく	出国
しゅつごく	出獄
しゅっさん	出産
しゅっし	出資
しゅつじ	出自
しゅっしゃ	出社
しゅっしょ	出処
しゅっしょ	出所
しゅっしょう	出生
しゅつじょう	出場
しゅっしょく	出色
しゅっしん	出身
しゅつじん	出陣
しゅっすい	出水
しゅっせ	出世
しゅっせい	出征
しゅっせい	出生
しゅっせき	出席
しゅっせきしゃ	出席者
しゅっそう	出走
しゅったい	出来
しゅつだい	出題
しゅっちょう	出張
しゅっちょう	出超
しゅってん	出典
しゅってん	出展
しゅってん	出店
しゅっとう	出頭
しゅつどう	出動
しゅつにゅう	出入
しゅつにゅうこく	出入国
しゅつば	出馬
しゅっぱつ	出発
しゅっぱん	出帆
しゅっぱん	出版
しゅっぴ	出費
しゅっぴん	出品
しゅつぼつ	出没
しゅっぽん	出奔
しゅつらい	出来
しゅつりょう	出漁
しゅつりょう	出猟
しゅつりょく	出力
しゅつるい	出塁
しゅと	首都
しゅとう	種痘
しゅどう	主導
しゅどう	手動
じゅどう	受動
じゅどうたい	受動態
しゅとく	取得
しゅとけん	首都圏
しゅとして	主として
じゅなん	受難
じゅにゅう	授乳
しゅにん	主任
しゅのう	首脳
じゅのう	受納
しゅはん	主犯
しゅはん	首班
しゅひ	守秘
しゅひ	種皮
しゅび	守備
しゅび	首尾
じゅひ	樹皮
しゅひつ	主筆
じゅひょう	樹氷
しゅひん	主賓
しゅふ	主夫
しゅふ	主婦
しゅふ	首府
しゅぶん	主文
じゅふん	受粉
しゅべつ	種別
しゅほ	酒保
しゅほう	主峰
しゅほう	手法
しゅぼう	首謀
しゅみ	趣味
じゅみょう	寿命
しゅむ	主務
しゅもく	種目
じゅもく	樹木
じゅもん	呪文
しゅやく	主役
じゅよ	授与
しゅよう	主要
じゅよう	受容
じゅよう	需要
しゅよく	主翼
しゅら	修羅
しゅらん	酒乱
じゅり	受理
じゅりつ	樹立
しゅりゅう	主流
しゅりょう	狩猟
しゅりょう	首領
じゅりょう	受領
じゅりょうしょう	受領証
しゅりょく	主力
しゅるい	種類
じゅれい	樹齢
しゅろ	棕櫚
しゅわ	手話
じゅわき	受話器
しゅん	旬
じゅん	准
じゅん	殉
じゅん	淳
じゅん	準
じゅん	潤
じゅん	純
じゅん	順
じゅんあい	純愛
じゅんい	準尉
じゅんい	順位
じゅんいつ	純一
しゅんえい	俊英
じゅんえき	純益
じゅんえん	巡演
じゅんえん	順延
じゅんか	純化
じゅんか	順化
じゅんかい	巡回
じゅんかいせき	順解析
しゅんかしゅうとう	春夏秋冬
じゅんかつ	潤滑
じゅんかつゆ	潤滑油
しゅんかん	瞬間
じゅんかん	准看
じゅんかん	循環
しゅんき	春季
しゅんきょ	峻拒
じゅんきょ	準拠
じゅんぎょう	巡業
じゅんきん	純金
じゅんぐり	順繰り
じゅんけつ	純潔
じゅんけつ	純血
じゅんけっしょう	準決勝
しゅんこう	竣工
じゅんこう	巡航
じゅんこう	巡行
じゅんさ	巡査
しゅんさい	俊才
じゅんさい	蓴菜
じゅんさつ	巡察
しゅんじ	瞬時
じゅんし	殉死
じゅんし	巡視
じゅんじ	順次
じゅんしゅ	遵守
しゅんじゅう	春秋
しゅんじゅん	逡巡
じゅんじゅん	順々
じゅんじゅん	諄々
じゅんじゅんけっしょう	準々決勝
じゅんじょ	順序
じゅんじょう	純情
じゅんしょく	殉職
じゅんしょく	純色
じゅんしん	純真
じゅんすい	純粋
じゅんせい	純正
じゅんせいてき	準静的
しゅんせつ	春雪
しゅんせつ	浚渫
じゅんせつ	順接
じゅんぞう	純増
しゅんそく	俊足
しゅんそく	駿足
じゅんたいげんじょし	準体言助詞
じゅんたいじょし	準体助詞
じゅんたく	潤沢
しゅんだん	春暖
じゅんち	馴致
じゅんちょう	順調
じゅんど	純度
しゅんとう	春闘
じゅんとう	順当
じゅんのう	順応
じゅんぱく	純白
しゅんぱつりょく	瞬発力
じゅんばん	順番
じゅんび	準備
じゅんびきん	準備金
しゅんびん	俊敏
じゅんぷう	順風
じゅんふどう	順不同
しゅんぶん	春分
しゅんべつ	峻別
じゅんぽう	遵法
じゅんぽう	順法
じゅんぼく	純朴
じゅんまい	純米
じゅんよう	準用
じゅんようかん	巡洋艦
じゅんり	純利
じゅんりょう	純良
じゅんりょう	順良
じゅんれい	巡礼
じゅんろ	順路
しょ	処
しょ	所
しょ	署
しょ	書
じょ	叙
じょ	序
じょ	恕
じょ	除
しょあく	諸悪
しょい	所為
じょい	女医
しょいん	所員
しょいん	署員
しょいん	書院
しょう	升
しょう	将
しょう	小
しょう	招
しょう	省
しょう	称
しょう	章
しょう	証
しょう	賞
しょう	性
しょう	生
しよう	仕様
しよう	使用
しよう	止揚
しよう	私用
しよう	試用
じょう	上
じょう	乗
じょう	場
じょう	嬢
じょう	情
じょう	条
じょう	状
じょう	錠
じよう	滋養
じょうあい	情愛
しょうあく	掌握
しょうい	小異
じょうい	上位
じょうい	譲位
しょういん	勝因
じょういん	上院
じょういん	乗員
じょうえい	上映
しょうえん	小宴
しょうえん	招宴
じょうえん	上演
しょうおう	照応
じょうおう	女王
しょうおん	消音
じょうおん	常温
しょうか	消化
しょうか	消火
しょうが	生姜
じょうか	浄化
しょうかい	商会
しょうかい	照会
しょうかい	紹介
しょうかい	詳解
しょうがい	傷害
しょうがい	渉外
しょうがい	障害
しょうがい	障碍
しょうがい	生涯
じょうかい	上界
じょうがい	場外
しょうかく	昇格
しょうがく	奨学
しょうがく	小学
しょうがく	小額
しょうがく	少額
しょうがくせい	奨学生
しょうがくせい	小学生
しょうがくぶ	商学部
じょうかそう	浄化槽
しょうがつ	正月
しょうがっこう	小学校
じょうかまち	城下町
しょうかん	償還
しょうかん	召喚
しょうかん	将官
しょうかん	小寒
じょうかん	上巻
じょうかん	上官
じょうかん	情感
しょうき	正気
しょうぎ	将棋
じょうき	上気
じょうき	上記
じょうき	常規
じょうき	蒸気
じょうぎ	定規
しょうきぼ	小規模
しょうきゃく	償却
しょうきゃく	消却
しょうきゃく	焼却
じょうきゃく	乗客
しょうきゅう	昇級
しょうきゅう	昇給
じょうきゅう	上級
しょうきょ	消去
しょうぎょう	商業
じょうきょう	上京
じょうきょう	状況
しょうきょく	消極
しょうきん	償金
しょうきん	賞金
じょうきん	常勤
じょうくう	上空
しょうぐん	将軍
じょうげ	上下
しょうけい	小計
しょうけい	象形
しょうけい	憧憬
じょうけい	情景
しょうげき	衝撃
しょうげきは	衝撃波
しょうけつ	焼結
しょうけん	証券
しょうけん	證券
しょうげん	証言
じょうけん	条件
じょうげん	上弦
じょうげん	上限
しょうこ	証拠
しょうご	正午
じょうこ	上古
じょうご	上戸
じょうご	漏斗
しょうこう	商工
しょうこう	将校
しょうこう	小康
しょうこう	昇降
しょうこう	消光
しょうこう	焼香
しょうこう	症候
しょうごう	商号
しょうごう	照合
しょうごう	称号
じょうこう	上皇
じょうこう	乗降
じょうこう	情工
じょうこう	条項
しょうこうぐん	症候群
しょうこうねつ	猩紅熱
しょうこく	小国
しょうこく	生国
しょうごく	生国
じょうこく	上告
しょうこん	商魂
しょうさ	小差
しょうさ	少佐
しょうさ	照査
しょうさい	商才
しょうさい	詳細
じょうさい	城砦
じょうざい	錠剤
しょうさん	勝算
しょうさん	消散
しょうさん	硝酸
しょうさん	称賛
しょうさん	賞賛
じょうさん	乗算
じょうさん	蒸散
じょうざん	乗算
しょうし	焼死
しょうし	笑止
しょうし	証紙
しょうじ	商事
しょうじ	障子
しょうじ	生じ
じょうし	上梓
じょうし	上司
じょうし	情死
じょうじ	常時
じょうじ	情事
しょうじき	正直
じょうしき	常識
しょうしつ	消失
しょうしつ	焼失
じょうしつ	上質
しょうしゃ	勝者
しょうしゃ	商社
しょうしゃ	小社
しょうしゃ	抄写
しょうしゃ	照射
しょうしゃ	瀟洒
しょうじゃ	精舎
じょうしゃ	乗車
じょうしゅ	城主
じょうじゅ	成就
しょうしゅう	召集
しょうしゅう	招集
しょうしゅう	消臭
しょうじゅう	小銃
しょうしゅくしゃく	小縮尺
しょうしゅつ	抄出
しょうじゅつ	詳述
じょうじゅつ	上述
しょうじゅん	照準
じょうじゅん	上旬
しょうしょ	小暑
しょうしょ	証書
しようしょ	仕様書
しょうじょ	少女
じょうしょ	情緒
じょうじょ	乗除
しょうしょう	少将
しょうしょう	少々
しょうじょう	症状
しょうじょう	賞状
じょうしょう	上昇
じょうじょう	上々
じょうじょう	上乗
じょうじょう	上場
じょうじょう	情状
じょうじょう	嫋々
しょうしょく	小職
しょうしょく	小食
しょうしょく	少食
じょうしょく	常食
しょうしん	傷心
しょうしん	小心
しょうしん	昇進
しょうしん	焼身
しょうしん	焦心
しょうしん	正真
しょうじん	精進
じょうしん	上申
じょうじん	常人
じょうしんこ	上新粉
じょうず	上手
しょうすい	小水
しょうすい	憔悴
じょうすい	上水
じょうすい	浄水
じょうすいどう	上水道
しょうすう	小数
しょうすう	少数
じょうすう	常数
じょうすう	定数
しょうせい	小生
しょうせい	招請
じょうせい	情勢
じょうせい	状勢
じょうせい	醸成
しょうせき	硝石
じょうせき	上席
じょうせき	定石
しょうせつ	小節
しょうせつ	小説
しょうせつ	小雪
しょうせつ	章節
しょうせつ	詳説
じょうせつ	常設
じょうぜつ	饒舌
しょうせつか	小説家
しょうせん	商船
じょうせん	乗船
しょうそ	勝訴
じょうそ	上訴
しょうそう	尚早
しょうそう	焦燥
しょうぞう	肖像
じょうそう	上層
じょうそう	情操
じょうぞう	醸造
しょうそく	消息
しょうぞく	装束
しょうたい	小隊
しょうたい	招待
しょうたい	正体
じょうたい	常態
じょうたい	状態
しょうたく	妾宅
しょうだく	承諾
じょうたつ	上達
しょうだて	章立て
しょうたん	賞嘆
しょうだん	商談
じょうたん	上端
じょうだん	上段
じょうだん	冗談
しょうち	承知
しょうち	招致
じょうち	上智
じょうち	常置
しょうちくばい	松竹梅
じょうちゃく	蒸着
しょうちゅう	掌中
しょうちゅう	焼酎
じょうちゅう	常駐
しょうちょ	小著
じょうちょ	情緒
しょうちょう	小腸
しょうちょう	消長
しょうちょう	省庁
しょうちょう	象徴
じょうちょう	冗長
しょうちん	消沈
じょうでき	上出来
しょうてん	商店
しょうてん	昇天
しょうてん	焦点
しょうてん	衝天
じょうてんき	上天気
しょうど	焦土
しょうど	照度
じょうと	譲渡
じょうど	浄土
しょうとう	消灯
しょうどう	衝動
じょうとう	上等
じょうとう	常套
じょうとうく	常套句
しょうどく	消毒
しょうとつ	衝突
しょうない	渉内
じょうない	城内
じょうない	場内
しょうなごん	少納言
しょうに	小児
しょうにゅうどう	鍾乳洞
しょうにん	商人
しょうにん	小人
しょうにん	承認
しょうにん	昇任
しょうにん	証人
じょうにん	常任
しょうね	性根
しょうねつ	焦熱
じょうねつ	情熱
しょうねん	少年
じょうねん	情念
しょうねんば	正念場
しょうのう	樟脳
しょうのう	笑納
じょうのう	上納
しょうは	小破
じょうば	乗馬
しょうはい	勝敗
しょうはい	賞杯
しょうばい	商売
しょうばつ	賞罰
じょうはつ	蒸発
しょうばん	相伴
じょうはんしん	上半身
しょうひ	消費
しょうび	焦眉
しょうび	賞美
じょうび	常備
しょうひしゃ	消費者
しょうひぜい	消費税
しょうひょう	商標
しょうびょう	傷病
しょうひん	商品
しょうひん	賞品
じょうひん	上品
しょうふ	娼婦
しょうぶ	勝負
じょうぶ	上部
じょうぶ	丈夫
しょうふく	妾腹
しょうふく	承伏
しょうふだ	正札
じょうぶつ	成仏
しょうぶん	性分
じょうぶん	条文
しょうへい	将兵
しょうへい	招聘
しょうへき	障壁
じょうへき	城壁
しょうへん	掌篇
しょうへん	掌編
しょうべん	小便
じょうほ	譲歩
しょうほう	商法
しょうぼう	消防
しょうぼう	焼亡
じょうほう	上方
じょうほう	情報
しょうぼうしょ	消防署
しょうほん	抄本
しょうまん	小満
しょうみ	賞味
しょうみ	正味
じょうみゃく	静脈
じょうみん	常民
じょうむ	乗務
じょうむ	常務
しょうめい	照明
しょうめい	証明
しょうめい	正銘
しょうめつ	消滅
しょうめん	正面
しょうもう	消耗
しょうもん	証文
じょうもん	縄文
しょうや	庄屋
しょうやく	抄訳
しょうやく	生薬
じょうやく	条約
じょうやど	常宿
じょうやど	定宿
しょうゆ	醤油
しょうよ	賞与
じょうよ	剰余
じょうよ	譲与
しょうよう	商用
しょうよう	慫慂
じょうよう	乗用
じょうよう	常用
じょうようしゃ	乗用車
しょうようじゅりん	照葉樹林
じょうよく	情欲
しょうらい	将来
しょうらい	招来
しょうらん	照覧
しょうらん	笑覧
じょうらん	上覧
じょうらん	擾乱
しょうり	勝利
じょうり	条理
じょうりく	上陸
しょうりゃく	省略
じょうりゅう	上流
じょうりゅう	蒸留
しょうりょ	焦慮
しょうりょう	小量
しょうりょう	少量
しょうりょう	渉猟
しょうりょく	省力
じょうりょく	常緑
じょうりょくじゅ	常緑樹
じょうるり	浄瑠璃
しょうれい	奨励
しょうれい	省令
じょうれい	常例
じょうれい	条例
じょうれん	常連
しょうろく	抄録
しょうろん	詳論
しょうわ	唱和
しょうわくせい	小惑星
しょうわる	性悪
しょえん	初演
じょえん	助演
じょおう	女王
しょか	初夏
しょか	書架
しょが	書画
しょかい	初会
しょかい	初回
しょがい	所外
じょがい	除外
じょがくせい	女学生
しょかつ	所轄
しょかん	所感
しょかん	所管
しょかん	書簡
しょき	初期
しょき	所期
しょき	書記
しょきちょう	書記長
しょきゅう	初級
じょきょ	除去
しょぎょう	所業
しょぎょう	諸行
じょきょうじゅ	助教授
しょぎょうむじょう	諸行無常
しょく	嘱
しょく	職
しょく	食
しょく	属
しよく	私欲
しょくあん	職安
しょくい	職位
しょくいん	職員
しょぐう	処遇
しょくえん	食塩
しょくぎょう	職業
しょくご	食後
しょくし	食指
しょくじ	植字
しょくじ	食事
しょくしゅ	職種
しょくしゅ	触手
しょくじゅ	植樹
しょくじゅう	職住
しょくしょう	職掌
しょくしょう	食傷
しょくしん	触診
しょくせい	植生
しょくせい	職制
しょくせいかつ	食生活
しょくせき	職責
しょくぜん	食前
しょくぜん	食膳
しょくだい	燭台
しょくたく	嘱託
しょくたく	食卓
しょくち	諸口
しょくちゅうどく	食中毒
しょくつう	食通
しょくどう	食堂
しょくどう	食道
しょくにく	食肉
しょくにん	職人
しょくのう	職能
しょくば	職場
しょくばい	触媒
しょくはつ	触発
しょくひ	食費
しょくひん	食品
しょくぶつ	植物
しょくぶん	職分
しょくほう	触法
しょくぼう	嘱望
しょくみんち	植民地
しょくむ	職務
しょくもう	植毛
しょくもく	属目
しょくもつ	食物
しょくよう	食用
しょくよく	食欲
しょくりょう	食料
しょくりょう	食糧
しょくりょうなん	食糧難
しょくりょうひん	食料品
しょくりん	植林
しょくれき	職歴
しょくん	諸君
じょくん	叙勲
しょけい	処刑
しょけい	諸兄
じょけつ	女傑
しょけん	初見
しょけん	所見
しょけん	書見
しょげん	緒言
しょげん	諸元
じょげん	助言
しょこ	書庫
しょこう	初校
じょこう	徐行
じょこう	除光
しょこく	諸国
しょこん	初婚
しょさ	所作
しょさい	所載
しょさい	書斎
しょざい	所在
じょさい	如才
しょざいち	所在地
しょざいな	所在な
じょさいな	如才な
しょさん	所産
じょさん	除算
じょざん	除算
じょさんぷ	助産婦
しょし	初志
しょし	諸氏
しょじ	所持
しょじ	諸事
じょし	助詞
じょし	女史
じょし	女子
じょじ	叙事
じょじ	女児
しょしき	書式
しょしき	諸式
じょしだい	女子大
しょしゃ	書写
じょしゅ	助手
しょしゅう	初秋
しょしゅう	所収
しょしゅつ	初出
じょじゅつ	叙述
しょしゅん	初春
しょじゅん	初旬
しょしょ	処暑
しょしょ	諸処
しょじょ	処女
しょしょう	書証
しょじょう	書状
じょしょう	序章
じょじょう	叙情
じょじょに	徐々に
しょしん	初審
しょしん	初心
しょしん	初診
しょしん	所信
しょしん	書信
しょしんしゃ	初心者
じょすうし	助数詞
しょせい	処世
しょせい	書生
しょぜい	諸税
じょせい	助勢
じょせい	助成
じょせい	女性
じょせい	女声
じょせい	女婿
しょせいくん	処世訓
しょせき	書籍
じょせき	除籍
しょせつ	諸説
じょせつ	序説
じょせつ	除雪
しょせん	所詮
しょせん	緒戦
しょそう	諸相
しょぞう	所蔵
じょそう	助走
じょそう	女装
じょそう	除草
しょそく	初速
しょぞく	所属
しょぞん	所存
しょたい	所帯
しょたい	書体
しょだい	初代
じょたい	除隊
しょたいめん	初対面
しょだな	書棚
しょだん	初段
しょち	処置
しょちゅう	暑中
しょちゅう	書中
じょちゅう	女中
しょちょう	初潮
しょちょう	所長
しょちょう	署長
じょちょう	助長
しょっかく	触覚
しょっかん	触感
しょっかん	食間
しょっき	食器
しょっきり	初っ切り
しょっくし	ショック死
しょっけん	職権
しょっけん	食券
しょっこう	職工
しょっぴ	しょっ引
しょて	初手
しょてい	所定
しょてん	書店
しょとう	初冬
しょとう	初等
しょとう	初頭
しょとう	諸島
しょどう	書道
じょどうし	助動詞
しょとく	所得
しょない	所内
しょにち	初日
しょにんきゅう	初任給
しょねんど	初年度
じょのくち	序の口
しょばつ	処罰
しょはん	初版
しょはん	初犯
しょはん	諸般
じょばん	序盤
しょひょう	書評
しょひょう	諸表
しょぶん	処分
じょぶん	序文
しょほ	初歩
しょほう	処方
しょほう	諸方
しょぼう	書房
しょほうせん	処方箋
じょまく	序幕
じょまくしき	除幕式
しょみん	庶民
しょむ	庶務
しょめい	署名
しょめい	書名
じょめい	助命
じょめい	除名
しょめん	書面
しょもう	所望
しょもつ	書物
じょや	除夜
じょやく	助役
しょゆう	所有
じょゆう	女優
しょゆうち	所有地
しょよう	所用
しょよう	所要
しょり	処理
じょりゅう	女流
じょりょく	助力
しょるい	書類
じょれつ	序列
しょろう	初老
じょろん	序論
しょんべん	小便
しら	知ら
しら	白
じらい	地雷
じらいげん	地雷原
しらが	白髪
しらかば	白樺
しらき	白木
しらくも	白癬
しらけ	白け
しらこ	白子
しらさぎ	白鷺
しらじらし	白々し
しらたま	白玉
しらたまこ	白玉粉
しらぬい	不知火
しらは	白羽
しらべ	調べ
しり	私利
しり	尻
しりあ	知り合
しりあい	知合い
じりき	自力
じりき	地力
しりごみ	後込み
しりごみ	尻込み
しりぞ	退
しりぞけ	斥け
しりぞけ	退け
しりつ	市立
しりつ	私立
じりつ	而立
じりつ	自律
じりつ	自立
じりつご	自立語
しりつぼみ	尻つぼみ
しりぬ	知り抜
しりぬぐい	尻拭い
しりめ	後目
しりめつれつ	支離滅裂
しりゅう	支流
じりゅう	時流
じりゅう	自流
しりょ	思慮
しりょう	史料
しりょう	思量
しりょう	死霊
しりょう	試料
しりょう	資料
しりょう	飼料
しりょく	死力
しりょく	視力
しりょく	資力
じりょく	磁力
しる	記
しる	汁
しるし	印
しるべ	標
しれい	司令
しれい	指令
じれい	事例
じれい	辞令
しれわた	知れ渡
しれん	試練
しろ	城
しろ	白
しろう	屍蝋
しろうと	素人
しろくじちゅう	四六時中
しろくま	白熊
しろくろ	白黒
しろざとう	白砂糖
しろじ	白地
しろっぽ	白っぽ
しろばい	白バイ
しろぼし	白星
しろみ	白身
しろむく	白無垢
しろもの	代物
しろやま	城山
しろん	史論
しろん	私論
じろん	持論
しわ	皺
しわく	思惑
しわけ	仕分け
しわけ	仕訳
しわざ	仕業
しわす	師走
しわよせ	しわ寄せ
しん	伸
しん	信
しん	心
しん	新
しん	真
しん	芯
しん	進
じん	仁
じん	陣
しんあい	親愛
じんあい	塵埃
しんあん	新案
しんい	深意
しんい	真意
じんい	人為
しんいり	新入り
じんいん	人員
しんうち	真打ち
しんえい	新鋭
しんえい	親衛
じんえい	陣営
しんえん	深遠
しんおう	震央
しんおん	心音
しんか	深化
しんか	真価
しんか	臣下
しんか	進化
じんか	人家
しんかい	深海
しんがい	侵害
しんがい	心外
じんかい	人海
じんかい	塵芥
じんかいせんじゅつ	人海戦術
しんかいち	新開地
しんがお	新顔
しんがく	神学
しんがく	進学
じんかく	人格
じんがさ	陣笠
しんがた	新型
しんかぶ	新株
しんかん	新刊
しんかん	新館
しんかんせん	新幹線
しんき	心機
しんき	新奇
しんき	新規
しんぎ	審議
しんぎ	真偽
じんぎ	仁義
しんぎかい	審議会
しんぎじゅつ	新技術
しんぎたい	心技体
しんきゅう	新旧
しんきゅう	進級
しんきょ	新居
しんきょう	信教
しんきょう	心境
しんきょく	新曲
しんきろう	蜃気楼
しんきろく	新記録
しんきん	信金
しんきん	心筋
しんきん	親近
しんぎん	呻吟
しんく	真紅
しんく	辛苦
しんぐ	寝具
しんくう	真空
しんぐう	新宮
じんぐう	神宮
しんくうかん	真空管
しんぐん	進軍
しんけい	神経
しんけいしつ	神経質
しんけいつう	神経痛
しんげき	進撃
しんけつ	心血
しんけん	真剣
しんけん	親権
しんげん	震源
じんけん	人件
じんけん	人権
しんげんち	震源地
じんけんひ	人件費
しんこう	信仰
しんこう	侵攻
しんこう	振興
しんこう	新興
しんこう	親交
しんこう	親好
しんこう	進行
しんごう	信号
じんこう	人口
じんこう	人工
しんこきゅう	深呼吸
しんこく	深刻
しんこく	申告
しんこく	親告
しんこくざい	親告罪
じんこつ	人骨
しんこっちょう	真骨頂
しんこん	新婚
しんさ	審査
しんさい	震災
じんさい	人災
じんざい	人材
しんさく	新作
しんさつ	新札
しんさつ	診察
しんさん	辛酸
しんざん	新参
しんし	紳士
しんじ	信じ
じんじ	人事
じんじか	人事課
しんしき	新式
しんしつ	寝室
しんじつ	真実
しんしゃ	新車
しんしゃ	深謝
しんじゃ	信者
じんじゃ	神社
しんしゃく	斟酌
しんしゅ	新種
しんしゅ	新酒
しんしゅ	進取
しんじゅ	真珠
じんしゅ	人種
しんじゅう	心中
しんしゅく	伸縮
しんしゅつ	侵出
しんしゅつ	浸出
しんしゅつ	進出
しんしゅん	新春
しんしょ	新書
しんしょう	心証
しんしょう	辛勝
しんじょう	信条
しんじょう	心情
しんじょう	身上
しんじょう	進上
じんじょう	尋常
しんしょうしゃ	身障者
しんしょうひん	新商品
しんしょく	侵食
しんしょく	侵蝕
しんしょく	寝食
しんしょく	浸食
しんしょく	浸蝕
しんしん	心身
しんしん	新進
しんしん	津津
しんじん	信心
しんじん	新人
じんしん	人身
しんすい	心酔
しんすい	浸水
しんすい	進水
しんずい	心髄
しんずい	真髄
しんずい	神髄
しんせい	新制
しんせい	新星
しんせい	新生
しんせい	申請
しんせい	真性
しんせい	真正
しんせい	神聖
じんせい	人生
じんせいかん	人生観
しんせいじ	新生児
しんせいひん	新製品
じんせいろん	人生論
しんせき	親戚
じんせき	人跡
しんせつ	新設
しんせつ	新説
しんせつ	新雪
しんせつ	親切
しんせん	心線
しんせん	新鮮
しんせん	神仙
しんせん	芯線
しんせん	震顫
しんぜん	神前
しんぜん	親善
じんせん	人選
しんそう	深層
しんそう	深窓
しんそう	真相
しんぞう	心臓
じんぞう	人造
じんぞう	腎臓
しんぞく	親族
じんそく	迅速
しんそこ	心底
しんそつ	新卒
しんたい	神体
しんたい	身体
しんたい	進退
しんだい	寝台
じんたい	人体
じんだい	甚大
しんたいせい	新体制
しんたいそう	新体操
しんたく	信託
しんたく	神託
しんたくぎんこう	信託銀行
しんだん	診断
しんち	新地
じんち	人知
じんち	陣地
しんちく	新築
じんちく	人畜
しんちゅう	心中
しんちゅう	真鍮
しんちゅう	進駐
じんちゅう	陣中
しんちょう	伸長
しんちょう	慎重
しんちょう	新調
しんちょう	深長
しんちょう	身長
じんちょうげ	沈丁花
しんちょく	進捗
しんちんたいしゃ	新陳代謝
しんつう	心痛
じんつう	陣痛
じんつうりき	神通力
しんてい	進呈
じんてい	人定
しんてき	心的
じんてき	人的
しんてん	伸展
しんてん	親展
しんてん	進展
しんでん	新田
しんでん	神殿
しんでんず	心電図
しんど	進度
しんど	震度
しんとう	心頭
しんとう	新党
しんとう	浸透
しんとう	親等
しんどう	振動
しんどう	神童
しんどう	震動
じんとう	陣頭
じんどう	人道
しんとうあつ	浸透圧
じんとく	人徳
しんにちは	親日派
しんにゅう	侵入
しんにゅう	新入
しんにゅう	浸入
しんにゅう	進入
しんにゅうがく	新入学
しんにゅうせい	新入生
しんにん	信任
しんにん	新任
しんねん	信念
しんねん	新年
しんねんかい	新年会
しんぱ	新派
じんば	人馬
しんぱい	心配
しんばし	新橋
しんはつばい	新発売
しんばん	新盤
しんぱん	侵犯
しんぱん	審判
しんび	審美
しんぴ	真否
しんぴ	神秘
しんぴょう	信憑
しんぴん	新品
しんぶ	深部
しんぷ	新婦
しんぷ	新譜
しんぷ	神父
しんぷう	新風
しんぷく	振幅
しんふぜん	心不全
しんぶつ	神仏
じんぶつ	人物
しんぶん	新聞
じんぶん	人文
しんぺん	身辺
しんぽ	進歩
しんぼう	信望
しんぼう	心棒
しんぼう	辛抱
しんぽう	信奉
しんぽう	新法
じんぼう	人望
しんぼく	神木
しんぼく	親睦
しんぽん	新本
しんまい	新米
しんみ	親身
しんみつ	親密
じんみゃく	人脈
しんみょう	神妙
じんみん	人民
しんめ	新芽
しんめい	身命
じんめい	人名
じんめい	人命
しんもつ	進物
しんもん	審問
じんもん	尋問
しんや	深夜
しんゆう	親友
しんよう	信用
じんよう	陣容
しんらい	信頼
しんらつ	辛辣
しんらばんしょう	森羅万象
しんり	審理
しんり	心理
しんり	真理
じんりきしゃ	人力車
しんりゃく	侵略
しんりょ	深慮
しんりょ	神慮
しんりょう	診療
しんりょく	新緑
じんりょく	人力
じんりょく	尽力
しんりん	森林
しんるい	親類
じんるい	人類
しんれい	心霊
しんろ	進路
しんろう	心労
しんろう	新郎
しんわ	神話
しんわ	親和
す	吸
す	空
す	好
す	漉
す	済
す	刷
す	擦
す	州
す	洲
す	住
す	酢
す	澄
す	摺
す	棲
す	素
す	巣
す	透
ず	図
ず	頭
すあし	素足
ずあん	図案
すい	水
すい	粋
ずい	随
ずい	髄
すいあげ	吸い上げ
すいあつ	水圧
すいい	推移
すいい	水位
ずいい	随意
すいいき	水域
ずいいち	随一
ずいいん	随員
すいえい	水泳
すいおん	水温
すいか	垂下
すいか	西瓜
すいか	誰何
すいがい	水害
すいがら	吸殻
すいきゅう	水球
すいきょ	推挙
すいきょう	粋狂
すいぎん	水銀
すいけい	推計
すいげん	水源
すいこ	吸い込
すいこう	推考
すいこう	推敲
すいこう	遂行
ずいこう	随行
すいさいが	水彩画
すいさつ	推察
すいさん	推算
すいさん	水産
すいさんか	水酸化
すいし	水死
すいじ	炊事
ずいじ	随時
すいしつ	水質
すいしゃ	水車
すいじゃく	衰弱
すいじゅん	水準
ずいしょ	随所
すいしょう	推奨
すいしょう	推賞
すいしょう	水晶
すいじょう	水上
すいじょうき	水蒸気
すいしん	垂心
すいしん	推進
すいしん	水深
すいせい	水性
すいせい	彗星
すいせん	垂線
すいせん	推薦
すいせん	水仙
すいせん	水洗
すいぜん	垂涎
すいそ	水素
すいそう	吹奏
すいそう	水槽
すいそう	水葬
すいぞう	膵臓
ずいそう	随想
すいそく	推測
すいぞくかん	水族館
すいたい	衰退
すいちゅう	水中
すいちゅうよくせん	水中翼船
すいちょく	垂直
すいてい	推定
すいてい	水底
すいてき	水滴
すいでん	水田
すいと	吸い取
すいとう	出納
すいとう	水稲
すいとう	水筒
すいどう	水道
すいなん	水難
すいばく	水爆
すいばん	水盤
ずいはん	随伴
すいはんき	炊飯器
ずいひつ	随筆
すいふ	水夫
すいぶん	水分
ずいぶん	随分
すいへい	水平
すいぼう	衰亡
すいぼくが	水墨画
すいぼつ	水没
すいま	睡魔
すいみゃく	水脈
すいみん	睡眠
すいめん	水面
すいもん	水門
すいよう	水曜
すいようえき	水溶液
すいようび	水曜日
すいり	推理
すいりゅう	水流
すいりょう	推量
すいりょう	水量
すいりょく	推力
すいりょく	水力
すいろ	水路
すいろん	推論
すう	数
すうかい	数回
すうがく	数学
すうき	数奇
すうこ	数個
すうこう	崇高
すうし	数詞
すうじ	数字
すうしき	数式
すうじく	枢軸
すうじつ	数日
ずうずうし	図々し
すうせい	趨勢
すうだい	数台
すうち	数値
すうにん	数人
すうはい	崇拝
すうめい	数名
すうよう	枢要
すうり	数理
すうりかがっか	数理科学科
すうりょう	数量
すうれつ	数列
すえ	据え
すえ	陶
すえ	末
すえお	据え置
すえきち	末吉
すえつけ	据え付け
すえなが	末長
すえひろ	末広
すか	透か
ずが	図画
ずかい	図解
ずがいこつ	頭蓋骨
すがお	素顔
すがた	姿
ずがら	図柄
ずかん	図鑑
すかんぴん	素寒貧
すき	隙
すき	好き
すき	鋤
すき	犁
すぎ	過ぎ
すぎ	杉
すぎさ	過ぎ去
すきずき	好きずき
すきっぱら	空きっ腹
すきとお	透き通
すきばら	空腹
すきま	すき間
すきま	隙間
すぎやま	杉山
すく	掬
すく	救
すく	巣食
すくいだ	救い出
すくな	少な
すくなからず	少なからず
すくなくとも	少なくとも
すぐれ	優れ
すけ	透け
ずけい	図形
すご	過ご
すご	凄
ずこう	図工
すこし	少し
すこしも	少しも
すこやか	健やか
すさまじ	凄まじ
すさまじさ	凄まじさ
ずざん	杜撰
すし	寿司
すし	鮨
すじ	筋
ずし	寿司
ずし	図示
ずし	逗子
すじがき	筋書
すじがき	筋書き
ずしき	図式
すじみち	筋道
すじょう	素性
ずじょう	図上
ずじょう	頭上
すじわる	筋悪
すす	進
すす	濯
すす	煤
すず	錫
すず	涼
すず	鈴
すずかぜ	涼風
すすき	薄
すずき	鱸
すずし	涼し
すすみだ	進み出
すすめ	勧め
すすめ	奨め
すすめ	進め
すすめ	薦め
すずめ	雀
すずめばち	雀蜂
すずらん	鈴蘭
すずり	硯
すそ	裾
ずぞう	図像
すその	裾野
すた	廃
すだ	巣立
すたれ	廃れ
すだれ	簾
ずつう	頭痛
すて	捨て
すで	素手
すてき	素敵
すてさ	捨て去
すでに	既に
すてばち	捨て鉢
すどおし	素通し
すどおり	素通り
すな	砂
すなお	素直
すながわ	砂川
すなじ	砂地
すなどけい	砂時計
すなば	砂場
すなはま	砂浜
すなやま	砂山
すなわち	即ち
すね	拗ね
ずのう	頭脳
すのもの	酢の物
すばこ	巣箱
すはだ	素肌
ずばぬけ	ずば抜け
すばや	素早
すばらし	素晴らし
すばる	昴
ずひょう	図表
ずふ	図譜
すぶた	酢豚
すべ	滑
すべ	術
すべ	統べ
すべて	全て
すべりおち	滑り落ち
すべりこ	滑り込
すべりだ	滑り出
ずほう	図法
ずぼし	図星
すま	済ま
すま	住ま
すま	澄ま
すまい	住い
すまい	住まい
すみ	角
すみ	隅
すみ	済
すみ	炭
すみ	墨
すみえ	墨絵
すみか	住処
すみこ	住み込
すみずみ	隅々
すみつ	住み着
すみなれ	住み慣れ
すみび	炭火
すみやか	速やか
ずめん	図面
すもう	相撲
すもも	李
すり	摺
すりかえ	すり替え
すりきれ	擦り切れ
すりこ	擦り込
すりぬけ	すり抜け
すりばち	すり鉢
すりばち	擂鉢
すりへ	すり減
すりへら	すり減ら
すりむ	擦りむ
するど	鋭
するめ	鯣
すれあ	擦れ合
ずれこ	ずれ込
すれちが	すれ違
ずろく	図録
すわ	座
すわ	据わ
すわりこ	座り込
すん	寸
すんか	寸暇
すんげき	寸劇
すんし	寸志
すんじ	寸時
すんぜん	寸前
すんだん	寸断
すんてつ	寸鉄
すんぴょう	寸評
すんぶん	寸分
すんぽう	寸法
すんわ	寸話
せ	競
せ	瀬
せ	背
ぜ	是
せい	所為
せい	制
せい	姓
せい	征
せい	性
せい	正
せい	生
せい	精
せい	製
ぜい	税
せいあつ	制圧
せいあん	成案
せいい	誠意
せいいく	成育
せいいく	生育
せいいつ	斉一
せいいっぱい	精いっぱい
せいいっぱい	精一杯
せいいん	成員
せいいん	成因
せいいん	正員
せいうん	星雲
せいうん	盛運
せいうん	青雲
せいえい	清栄
せいえい	精鋭
せいえき	精液
せいえん	声援
せいえん	製塩
せいおん	清音
せいおん	静穏
せいか	成果
せいか	正価
せいか	正課
せいか	生家
せいか	生花
せいか	盛夏
せいか	精華
せいか	聖歌
せいか	聖火
せいか	製菓
せいか	青果
せいかい	政界
せいかい	正解
せいかい	盛会
せいかい	精解
せいかく	性格
せいかく	正確
せいがく	声楽
ぜいがく	税額
せいかつ	生活
せいかん	生還
せいかん	精悍
せいかん	静観
せいがん	請願
ぜいかん	税関
せいき	世紀
せいき	性器
せいき	正規
せいき	生気
せいき	生起
せいき	精機
せいき	精気
せいぎ	正義
せいきか	正規化
せいきまつ	世紀末
せいきゅう	性急
せいきゅう	請求
せいきょ	盛挙
せいきょ	逝去
せいぎょ	制御
せいきょう	生協
せいきょう	盛況
せいぎょう	成業
せいぎょう	盛業
せいきょく	政局
せいきん	精勤
ぜいきん	税金
せいくう	制空
せいぐん	西軍
せいけい	成形
せいけい	整形
せいけい	生計
せいけつ	清潔
せいけん	政権
せいけん	政見
せいげん	制限
せいげん	正弦
ぜいげん	税源
ぜいげん	贅言
せいご	成語
せいご	正誤
せいご	生後
せいこう	性交
せいこう	成功
せいこう	生硬
せいこう	精巧
せいこう	精鋼
せいこう	製鋼
せいごう	整合
せいこううどく	晴耕雨読
せいこうほう	正攻法
せいこく	正鵠
せいこつ	整骨
ぜいこみ	税込み
せいこん	成婚
せいこん	精魂
せいさ	性差
せいさ	精査
せいざ	星座
せいざ	正座
せいさい	制裁
せいさい	正妻
せいさい	精細
せいざい	製材
せいざいかい	政財界
せいさく	制作
せいさく	政策
せいさく	製作
せいさん	凄惨
せいさん	成算
せいさん	正餐
せいさん	清算
せいさん	生産
せいさん	精算
せいさんだか	生産高
せいさんち	生産地
せいし	制止
せいし	正視
せいし	生死
せいし	精子
せいし	製紙
せいし	静止
せいじ	政治
せいじ	青磁
せいじか	政治家
せいしき	制式
せいしき	正式
せいしつ	性質
せいしつ	声質
せいじつ	誠実
せいじゃ	正邪
せいじゃ	聖者
せいしゃいん	正社員
せいじゃく	静寂
ぜいじゃく	脆弱
せいしゅ	清酒
ぜいしゅう	税収
せいじゅく	成熟
せいしゅん	青春
せいじゅん	清純
せいしょ	清書
せいしょ	聖書
せいじょ	整除
せいしょう	清勝
せいしょう	清祥
せいしょう	斉唱
せいじょう	政情
せいじょう	正常
せいじょう	清浄
せいじょうき	星条旗
せいしょうねん	青少年
せいしょく	生殖
せいしょく	生色
せいしょく	聖職
せいしん	星辰
せいしん	精神
せいしん	誠心
せいじん	成人
せいしんか	精神科
せいず	星図
せいず	製図
せいすい	盛衰
せいすい	聖水
せいすう	整数
せいすう	正数
せいせい	清々
せいせい	生成
せいせい	精製
ぜいせい	税制
せいせいどうどう	正々堂々
せいせき	成績
せいせつ	正接
せいせん	生鮮
せいせん	精選
せいぜん	整然
せいぜん	生前
せいそ	清楚
せいそう	政争
せいそう	正装
せいそう	清掃
せいそう	盛装
せいぞう	製造
せいそく	棲息
せいそく	生息
せいぞろい	勢ぞろい
せいぞん	生存
せいたい	生体
せいたい	生態
せいたい	声帯
せいだい	盛大
せいたかくけい	正多角形
せいたかくちゅう	正多角柱
ぜいたく	贅沢
せいち	整地
せいち	生地
せいち	精緻
せいち	聖地
せいちゃ	製茶
せいちゅう	成虫
せいちょう	成長
せいちょう	整調
せいちょう	正調
せいちょう	清澄
せいちょう	生長
せいちょう	静聴
せいつう	精通
せいてい	制定
せいてき	性的
せいてき	政敵
せいてき	静的
せいてつ	製鉄
せいてん	晴天
せいてん	盛典
せいてん	聖典
せいでんき	静電気
せいと	生徒
せいど	制度
せいど	精度
せいとう	政党
せいとう	正当
せいとう	正答
せいとう	正統
せいとう	製糖
せいどう	制動
せいどう	聖堂
せいどう	青銅
せいどうき	青銅器
せいどく	精読
せいとん	整頓
せいなる	聖なる
せいにく	精肉
ぜいにく	ぜい肉
ぜいにく	贅肉
せいねん	成年
せいねん	青年
せいねんがっぴ	生年月日
せいのう	性能
せいは	制覇
せいばい	成敗
せいはく	精白
せいばつ	征伐
せいはん	製版
せいはんたい	正反対
せいひ	成否
せいひ	正否
せいび	整備
せいひつ	静謐
せいひょう	製氷
せいひん	清貧
せいひん	製品
せいふ	政府
せいふ	正負
せいぶ	声部
せいぶ	西武
せいぶ	西部
せいふく	制服
せいふく	征服
せいぶつ	生物
せいぶつ	静物
せいふん	製粉
せいぶん	成分
せいへき	性癖
せいべつ	性別
せいぼ	歳暮
せいぼ	生母
せいほう	正方
せいほう	製法
せいほう	西方
せいぼう	制帽
せいぼう	声望
ぜいほう	税法
せいほうけい	正方形
せいほん	製本
せいまい	精米
せいみつ	精密
ぜいむ	税務
ぜいむしょ	税務署
せいめい	姓名
せいめい	清明
せいめい	生命
せいめい	声明
せいめん	製麺
せいもん	正門
せいやく	制約
せいやく	成約
せいやく	製薬
せいやく	誓約
せいゆ	製油
せいゆう	声優
せいよう	静養
せいよく	性欲
せいらい	生来
せいり	整理
せいり	生理
ぜいりし	税理士
せいりつ	成立
ぜいりつ	税率
せいりゃく	政略
せいりゅう	整流
せいりゅう	清流
せいりゅうき	整流器
せいりょう	清涼
せいりょう	声量
せいりょく	勢力
せいりょく	精力
せいれい	政令
せいれい	精励
せいれい	精霊
せいれき	西暦
せいれつ	整列
せいれつ	清冽
せいれん	清廉
せいれん	精錬
せいろ	蒸篭
せいろん	正論
せお	背負
せおよぎ	背泳ぎ
せかい	世界
せき	堰
せき	咳
せき	関
せき	寂
せき	隻
せき	席
せき	積
せき	籍
せき	責
せきか	石化
せきがいせん	赤外線
せきがえ	席替え
せきがく	碩学
せきさい	積載
せきざい	石材
せきさん	積算
せきじゅうじ	赤十字
せきしゅつ	析出
せきじょう	席上
せきしょく	赤色
せきずい	脊髄
せきせつ	積雪
せきぞう	石像
せきたん	石炭
せきつい	脊椎
せきてい	石庭
せきどう	赤道
せきとめ	せき止め
せきとり	関取
せきにん	責任
せきにんしゃ	責任者
せきねつ	赤熱
せきねん	積年
せきはい	惜敗
せきはん	赤飯
せきばん	石版
せきひ	石碑
せきひん	赤貧
せきぶん	積分
せきべつ	惜別
せきむ	責務
せきめん	赤面
せきゆ	石油
せきら	赤裸
せきらら	赤裸々
せきり	赤痢
せきりょう	責了
せきりょく	斥力
せきわ	積和
せきわけ	関脇
せけん	世間
ぜげん	女衒
せこう	施工
せじ	世事
せじ	世辞
せしゅう	世襲
せじょう	施錠
せじょう	世情
せすじ	背筋
ぜせい	是正
せそう	世相
せぞく	世俗
せたい	世帯
せだい	世代
せたけ	背丈
せっ	接
せつ	切
せつ	節
せつ	説
ぜっ	絶
せつえい	設営
ぜつえん	絶縁
ぜっか	舌禍
せっかい	石灰
せっかい	切開
せつがい	雪害
せっかいがん	石灰岩
せっかく	折角
せっかん	折檻
せつがん	接岸
せっき	石器
せっき	節気
せっきゃく	接客
せっきょう	説教
ぜっきょう	絶叫
せっきょく	積極
せっきん	接近
せっく	節句
ぜっく	絶句
せっけい	設計
ぜっけい	絶景
せっけいし	設計士
せっけいず	設計図
せっけっきゅう	赤血球
せっけん	石鹸
せっけん	接見
せつげん	節減
せつげん	雪原
ぜつご	絶後
せっこう	斥候
せっこう	石膏
せっこう	拙稿
せつごう	接合
ぜっこう	絶交
ぜっこう	絶好
ぜっこうちょう	絶好調
せっこつ	接骨
せっさく	切削
せっさく	拙作
せっさたくま	切磋琢磨
ぜっさん	絶賛
せっし	摂氏
せっし	窃視
せつじ	接辞
せつじつ	切実
せっしゃ	拙者
せっしやくわん	切歯扼腕
せっしゅ	接種
せっしゅ	摂取
せつじゅ	接受
せっしゅう	接収
せつじょ	切除
せっしょう	殺生
せっしょう	摂政
せっしょう	折衝
ぜっしょう	絶唱
せっしょく	接触
せっしょく	節食
せつじょく	雪辱
ぜっしょく	絶食
せっすい	節水
せっせい	摂生
せっせい	節制
せつぜい	節税
ぜっせい	絶世
せつせつ	切々
せっせん	接戦
せっせん	接線
せっそう	節操
せっそく	拙速
せっそく	節足
せつぞく	接続
せつぞくし	接続詞
せったい	接待
ぜったい	絶対
ぜつだい	絶大
ぜったいぜつめい	絶体絶命
ぜったいち	絶対値
せったく	拙宅
せつだん	切断
せっち	設置
せっちゃく	接着
せっちゅう	折衷
せっちょ	拙著
ぜっちょう	絶頂
せっちん	雪隠
せってい	設定
せってん	接点
せつでん	節電
せつど	節度
せっとう	接頭
せっとう	窃盗
せつどう	摂動
せっとく	説得
せつな	切な
せつな	刹那
せっぱく	切迫
せっぱつま	切羽詰ま
せっぱん	折半
ぜっぱん	絶版
せつび	接尾
せつび	設備
せつびご	接尾語
ぜっぴつ	絶筆
ぜっぴん	絶品
せっぷく	切腹
せつぶん	節分
せっぷん	接吻
ぜっぺき	絶壁
せつぼう	切望
せっぽう	説法
ぜつぼう	絶望
ぜっぽう	舌鋒
ぜつみょう	絶妙
ぜつむ	絶無
せつめい	説明
ぜつめい	絶命
ぜつめつ	絶滅
せつもん	設問
せつやく	節約
せつり	摂理
せつりつ	設立
せつわ	説話
せと	瀬戸
せとぎわ	瀬戸際
せともの	瀬戸物
せなか	背中
ぜに	銭
ぜにん	是認
せのび	背伸び
せばま	狭ま
せばめ	狭め
ぜひ	是非
せびろ	背広
せぼね	背骨
せま	狭
せま	迫
せまくるし	狭苦し
せみ	蝉
せめ	攻め
せめ	責
せめ	責め
せめおと	攻め落と
せめぎあ	せめぎ合
せめく	責苦
せめこ	攻め込
せめたて	責めたて
せめつけ	責めつけ
せり	芹
せりあ	競り合
せりあげ	せり上げ
せりふ	台詞
ぜろ	零
せろん	世論
せわ	世話
せん	千
せん	宣
せん	撰
せん	栓
せん	煎
せん	線
せん	選
ぜん	千
ぜん	前
ぜん	善
ぜん	全
ぜん	禅
ぜん	膳
ぜんあく	善悪
せんい	戦意
せんい	繊維
せんい	遷移
ぜんい	善意
ぜんいき	全域
せんいん	船員
ぜんいん	全員
せんえい	先鋭
せんえい	尖鋭
ぜんえい	前衛
せんえき	戦役
せんえつ	僭越
せんおう	専横
せんか	専科
せんか	戦果
せんか	戦火
せんか	戦禍
ぜんか	前科
せんかい	旋回
せんがい	選外
ぜんかい	前回
ぜんかい	全会
ぜんかい	全壊
ぜんかい	全快
ぜんかい	全開
せんかく	先覚
せんがく	先学
せんがく	浅学
ぜんがく	全学
ぜんがく	全額
せんかん	戦艦
せんがん	洗顔
ぜんかん	全巻
ぜんかん	全館
せんき	戦記
せんぎ	詮議
ぜんき	前期
ぜんき	前記
ぜんき	全機
せんきゃく	船客
せんきゃくばんらい	千客万来
せんきょ	占拠
せんきょ	選挙
せんぎょ	鮮魚
せんきょう	戦況
せんぎょう	専業
せんきょうし	宣教師
せんきょく	戦局
せんきょく	選曲
ぜんきょく	全局
ぜんきょく	全曲
ぜんきん	漸近
せんく	先駆
ぜんく	前駆
ぜんく	全区
せんぐう	遷宮
ぜんけい	前傾
ぜんけい	前掲
ぜんけい	全形
ぜんけい	全景
せんけつ	先決
せんけつ	鮮血
せんげつ	先月
ぜんけつ	全血
ぜんげつ	前月
せんけん	先見
せんげん	宣言
せんげん	選言
ぜんけん	全検
ぜんけん	全権
ぜんけん	全県
ぜんげん	前言
ぜんげん	漸減
せんご	戦後
ぜんこ	全戸
ぜんご	前後
せんこう	先攻
せんこう	先行
せんこう	専攻
せんこう	潜航
せんこう	穿孔
せんこう	線香
せんこう	選考
せんこう	閃光
ぜんこう	前項
ぜんこう	善行
ぜんこう	全校
せんこく	先刻
せんこく	宣告
せんごく	戦国
ぜんこく	全国
せんごくぶね	千石船
ぜんごさく	善後策
せんさい	戦災
せんさい	繊細
せんざい	千載
せんざい	洗剤
せんざい	潜在
ぜんさい	前菜
せんざいいちぐう	千載一遇
せんさく	詮索
ぜんさく	前作
せんさばんべつ	千差万別
せんし	先史
せんし	戦士
せんし	戦死
せんじ	戦時
せんじ	煎じ
ぜんし	全市
ぜんし	全紙
ぜんじ	漸次
せんしつ	船室
せんじつ	先日
ぜんじつ	前日
ぜんじつ	全日
せんしゃ	戦車
せんじゃ	選者
ぜんしゃ	前者
ぜんしゃ	全社
せんしゅ	先取
せんしゅ	専守
せんしゅ	船首
せんしゅ	選手
せんしゅう	先週
せんしゅう	専修
せんしゅう	選集
せんじゅう	専従
ぜんしゅう	前週
ぜんしゅう	全集
ぜんしゅう	禅宗
せんしゅうらく	千秋楽
せんしゅつ	選出
せんじゅつ	仙術
せんじゅつ	先述
せんじゅつ	戦術
ぜんじゅつ	前述
ぜんしょ	善処
ぜんしょ	全書
せんしょう	先勝
せんしょう	僭称
せんじょう	戦場
せんじょう	扇状
せんじょう	洗浄
せんじょう	煽情
せんじょう	線上
せんじょう	船上
ぜんしょう	前章
ぜんしょう	全勝
ぜんしょう	全焼
ぜんしょう	全章
ぜんしょうきごう	全称記号
ぜんしょうせん	前哨戦
せんしょく	染織
せんしょく	染色
せんしょくたい	染色体
せんしん	先進
せんしん	専心
せんじん	先人
せんじん	千尋
ぜんしん	前身
ぜんしん	前進
ぜんしん	漸進
ぜんしん	全身
せんしんこく	先進国
せんす	扇子
せんすい	潜水
せんすいかん	潜水艦
せんせい	先生
せんせい	宣誓
ぜんせい	全盛
ぜんせいき	全盛期
せんせいじゅつ	占星術
せんせき	船籍
ぜんせき	全席
せんせん	宣戦
せんせん	戦線
せんぜん	戦前
ぜんせん	前線
ぜんせん	全線
ぜんぜん	全然
せんせんしゅう	先々週
せんぞ	先祖
せんそう	戦争
ぜんそう	前奏
ぜんぞう	漸増
せんぞがえり	先祖返り
せんぞく	専属
ぜんそく	喘息
せんた	センタ
せんたい	船体
せんだい	先代
ぜんたい	全体
ぜんだい	前代
せんたく	洗濯
せんたく	選択
せんたくき	洗濯機
せんたくし	選択肢
ぜんだま	善玉
せんたん	先端
せんたん	尖端
せんたん	戦端
せんだん	栴檀
せんだん	船団
せんだん	剪断
ぜんたん	前端
せんち	戦地
ぜんち	全治
ぜんちし	前置詞
せんちゃ	煎茶
せんちゃく	先着
ぜんちょ	前著
せんちょう	船長
ぜんちょう	前兆
ぜんちょう	全長
ぜんつう	全通
せんて	先手
せんてい	選定
せんてい	剪定
ぜんてい	前提
せんでき	洗滌
せんてつ	銑鉄
ぜんでら	禅寺
せんてん	先天
せんてん	尖点
せんでん	宣伝
ぜんてん	全店
せんと	遷都
せんど	先途
せんど	鮮度
ぜんと	前途
ぜんど	全土
せんとう	先頭
せんとう	尖塔
せんとう	戦闘
せんとう	銭湯
せんどう	先導
せんどう	船頭
ぜんとう	全島
ぜんどう	善導
ぜんどう	蠕動
せんとうき	戦闘機
せんない	船内
ぜんにちせい	全日制
ぜんにほん	全日本
せんにゅう	潜入
せんにゅうかん	先入観
せんにん	仙人
せんにん	専任
せんにん	選任
ぜんにん	前任
ぜんにん	善人
せんねん	専念
ぜんねんど	前年度
せんのう	洗脳
ぜんのう	前納
せんば	船場
せんばい	専売
せんぱい	先輩
ぜんぱい	全廃
ぜんぱい	全敗
せんぱく	船舶
せんばつ	選抜
せんぱつ	先発
せんぱつ	洗髪
せんばづる	千羽鶴
せんばん	千万
せんばん	旋盤
せんぱん	先般
せんぱん	戦犯
ぜんはん	前半
ぜんぱん	前半
ぜんぱん	全般
せんび	船尾
せんぴ	戦費
せんびょう	線描
せんぴょう	線表
せんぴょう	選評
せんびょうしつ	腺病質
せんびん	船便
ぜんびん	前便
ぜんびん	全便
ぜんぴん	全品
せんぶ	先負
せんぷ	先負
せんぷ	戦斧
ぜんぶ	全部
せんぷう	旋風
せんぷうき	扇風機
せんぷく	潜伏
せんぶん	線分
ぜんぶん	前文
ぜんぶん	全文
せんべい	煎餅
せんぺい	尖兵
せんべつ	選別
せんべつ	餞別
せんべん	先鞭
ぜんぺん	前編
ぜんぺん	全編
せんぼう	羨望
せんぽう	先方
せんぽう	戦法
せんぽう	旋法
ぜんぼう	全貌
ぜんぽう	前方
せんぼうきょう	潜望鏡
せんぼつ	戦没
せんまけ	先負
せんみん	賎民
せんみん	選民
せんむ	専務
せんめい	鮮明
せんめつ	殲滅
ぜんめつ	全滅
せんめん	洗面
ぜんめん	前面
ぜんめん	全面
せんめんき	洗面器
せんもう	繊毛
せんもう	譫妄
せんもん	専門
せんもんか	専門家
ぜんや	前夜
せんやく	先約
ぜんやく	全訳
せんゆう	占有
せんゆう	専有
せんゆう	戦友
せんよう	専用
ぜんよう	善用
ぜんよう	全容
ぜんら	全裸
せんり	千里
せんり	戦利
せんりがん	千里眼
せんりつ	戦慄
せんりつ	旋律
せんりゃく	戦略
ぜんりゃく	前略
せんりゅう	川柳
せんりょ	千慮
せんりょ	浅慮
せんりょう	占領
せんりょう	染料
せんりょう	線量
ぜんりょう	善良
せんりょく	戦力
ぜんりょく	全力
せんれい	先例
せんれい	洗礼
ぜんれい	前例
ぜんれき	前歴
せんれつ	鮮烈
ぜんれつ	前列
せんれん	洗練
せんろ	線路
そ	沿
そ	祖
そ	素
そ	剃
そ	添
そ	反
そあく	粗悪
そいん	素因
そいん	訴因
そいんし	素因子
そいんすう	素因数
そう	宗
そう	僧
そう	奏
そう	宋
そう	層
そう	槽
そう	相
そう	総
そう	草
そう	荘
ぞう	象
ぞう	像
ぞう	増
ぞう	蔵
そうあい	相愛
そうあん	草案
そうい	創意
そうい	創痍
そうい	相違
そういん	総員
ぞういん	増員
そううつ	躁鬱
ぞうえい	造営
ぞうえき	増益
ぞうえん	増援
ぞうえん	造園
ぞうお	憎悪
そうおう	相応
そうおん	騒音
そうが	挿画
ぞうか	増加
ぞうか	造花
そうかい	壮快
そうかい	爽快
そうかい	掃海
そうかい	総会
そうがい	霜害
そうがく	総額
ぞうがく	増額
そうかつ	総括
そうかつ	総轄
そうかん	創刊
そうかん	壮観
そうかん	層間
そうかん	相姦
そうかん	相関
そうかん	総監
そうかん	送還
ぞうかん	増刊
そうがんきょう	双眼鏡
そうき	想起
そうき	早期
そうぎ	争議
そうぎ	葬儀
ぞうき	雑木
ぞうき	臓器
ぞうきばやし	雑木林
そうきゅう	早急
そうきょ	壮挙
そうぎょう	創業
そうぎょう	操業
ぞうきょう	増強
そうきょく	総局
そうきょくし	双極子
そうきょくせん	双曲線
そうきん	送金
ぞうきん	雑巾
そうぐう	遭遇
そうくつ	巣窟
そうけ	宗家
ぞうげ	象牙
そうけい	早計
そうけい	総計
そうげい	送迎
ぞうけい	造形
ぞうけい	造詣
ぞうけつ	増結
そうけん	壮健
そうけん	送検
そうげん	創元
そうげん	草原
ぞうげん	増減
そうこ	倉庫
そうご	相互
ぞうご	造語
そうこう	壮行
そうこう	操行
そうこう	糟糠
そうこう	草稿
そうこう	装甲
そうこう	走行
そうこう	霜降
そうごう	相好
そうごう	総合
そうこく	相克
そうこん	早婚
そうごん	荘厳
ぞうごん	雑言
そうさ	捜査
そうさ	操作
そうさ	走査
ぞうさ	造作
そうさい	相殺
そうさい	総裁
そうざい	惣菜
そうさく	創作
そうさく	捜索
ぞうさく	増作
ぞうさく	造作
ぞうさつ	増刷
ぞうさん	増産
そうし	創始
そうし	相思
そうし	草紙
そうじ	掃除
そうじ	相似
ぞうし	増資
そうしき	葬式
そうじしょく	総辞職
そうしつ	喪失
そうじて	総じて
そうしゃ	奏者
そうしゃ	掃射
そうしゃ	操車
そうしゃ	走者
そうじゅ	送受
そうじゅう	操縦
ぞうしゅう	増収
そうしゅうへん	総集編
ぞうしゅうわい	贈収賄
そうじゅく	早熟
そうしゅつ	送出
そうしゅん	早春
そうしょ	草書
ぞうしょ	蔵書
そうしょう	宗匠
そうしょう	総称
そうじょう	僧上
そうじょう	相乗
そうじょう	騒擾
ぞうしょう	蔵相
そうしょく	草食
そうしょく	装飾
ぞうしょく	増殖
そうしん	痩身
そうしん	装身
そうしん	送信
ぞうしん	増進
そうず	挿図
ぞうすい	雑炊
ぞうすい	増水
そうすう	総数
そうせい	創製
そうせい	叢生
そうせい	早世
そうせい	早逝
そうぜい	総勢
ぞうせい	造成
ぞうぜい	増税
そうせいじ	双生児
そうせつ	創設
そうぜつ	壮絶
ぞうせつ	増設
そうぜん	騒然
ぞうせん	造船
そうそう	早々
そうそう	草々
そうそう	錚々
そうぞう	創造
そうぞう	想像
そうぞう	送像
そうぞうし	騒々し
そうそく	総則
そうぞく	相続
そうだ	操舵
そうたい	早退
そうたい	相対
そうたい	総体
そうだい	壮大
そうだい	総代
ぞうだい	増大
そうたいち	相対値
そうたいてき	相対的
そうだか	総高
そうだち	総立ち
そうたつ	送達
そうだつ	争奪
そうだん	相談
そうだんしょ	相談所
そうち	装置
そうち	送致
ぞうちく	増築
そうちゃく	装着
そうちょう	早朝
そうちょう	総長
そうちょう	荘重
ぞうちょう	増長
そうつい	双対
そうで	総出
そうてい	想定
そうてい	装丁
そうてい	送呈
ぞうてい	贈呈
そうてん	争点
そうてん	装填
そうでん	送電
そうと	壮図
そうと	壮途
そうとう	双頭
そうとう	掃討
そうとう	相当
そうとう	総統
そうどう	騒動
ぞうとう	贈答
そうとく	総督
そうなん	遭難
ぞうに	雑煮
そうにゅう	挿入
そうねん	壮年
そうねん	想念
そうは	掻爬
そうは	走破
そうば	相場
そうはい	送配
ぞうはつ	増発
そうはん	相反
そうばん	早晩
そうび	装備
そうひょう	総評
そうびょう	躁病
ぞうびん	増便
そうふ	送付
そうふう	送風
ぞうふく	増幅
そうべつ	送別
そうほ	相補
ぞうほ	増補
そうほう	双方
そうほうこう	双方向
そうむ	総務
ぞうむし	象虫
そうめい	聡明
そうめい	聰明
そうめん	素麺
ぞうよ	贈与
そうよう	装用
そうらん	総覧
そうらん	騒乱
そうり	総理
ぞうり	草履
そうりつ	創立
そうりふ	総理府
そうりょ	僧侶
そうりょう	総量
そうりょう	総領
そうりょう	送料
そうりょく	総力
ぞうりょく	増力
ぞうりん	造林
そうるい	走塁
そうれつ	壮烈
そうれつ	葬列
そうろう	候
そうろう	早漏
そうろうぶん	候文
そうろん	総論
そうわ	挿話
そうわ	総和
ぞうわい	贈賄
そえ	添え
そえん	疎遠
そかい	疎開
そかい	租界
そがい	疎外
そがい	阻害
そかく	疎隔
そかく	組閣
そきゅう	遡及
そく	則
そく	即
そく	息
そく	束
そく	足
ぞく	俗
ぞく	属
ぞく	賊
ぞく	族
ぞくあく	俗悪
そくい	即位
そくいん	惻隠
そくおう	即応
そくおん	促音
ぞくぐん	賊軍
ぞくご	俗語
そくざ	即座
そくし	側視
そくし	即死
そくじ	即時
ぞくじ	俗字
そくじつ	即日
ぞくしゅう	俗習
ぞくしゅつ	続出
ぞくしょう	俗称
そくしん	促進
ぞくしん	続伸
ぞくじん	属人
そくせい	促成
ぞくせい	属性
そくせき	即席
そくせき	足跡
ぞくせつ	俗説
ぞくぞく	続々
そくたい	束帯
そくだく	即諾
そくたつ	速達
そくだん	即断
そくち	測地
ぞくち	属地
そくてい	測定
そくど	測度
そくど	速度
そくとう	即答
そくとう	速答
ぞくとう	続投
ぞくとう	続騰
そくばい	即売
そくばく	束縛
そくはつ	即発
ぞくはつ	続発
ぞくぶつ	俗物
そくぶつてき	即物的
ぞくへん	続編
そくほう	速報
ぞくほう	続報
そくめん	側面
ぞくらく	続落
ぞくりゅう	俗流
そくりょう	測量
ぞくりょう	属領
そくりょく	速力
そくろう	足労
ぞくろん	俗論
そげき	狙撃
そこ	底
そご	齟齬
そこいじ	底意地
そこう	素行
そこく	祖国
そこぢから	底力
そこな	損な
そこね	損ね
そこね	底値
そこびえ	底冷え
そこびき	底引き
そさい	蔬菜
そざい	素材
そざつ	粗雑
そし	素子
そし	阻止
そし	誹
そじ	素地
そしき	組織
そしつ	素質
そしな	粗品
そしゃく	租借
そしゃく	咀嚼
そしょう	訴訟
そじょう	訴状
そじょう	俎上
そじょう	溯上
そしょく	粗食
そすい	疎水
そすう	素数
そせい	塑性
そせい	粗製
そせい	組成
そせい	蘇生
そぜい	租税
そせん	祖先
そそ	唆
そそ	楚々
そそ	注
そそう	粗相
そそぎぐち	注ぎ口
そそのか	唆
そそりた	そそり立
そだ	育
そだい	粗大
そだて	育て
そだてあげ	育て上げ
そち	措置
そつ	卒
そつう	疎通
ぞっか	俗化
そっき	速記
そっきゅう	速急
そっきょう	即興
そつぎょう	卒業
そつぎょうしき	卒業式
そっきん	側近
そっきん	即金
そっけつ	即決
そっこう	即効
そっこう	速攻
ぞっこう	続行
そっこうじょ	測候所
そっこく	即刻
ぞっこく	属国
そつじゅ	卒寿
そっせん	率先
そっちゅう	卒中
そっちょく	率直
そっとう	卒倒
そっぷがた	ソップ形
そつろん	卒論
そで	袖
そてい	措定
そと	外
そとがわ	外側
そとづら	外面
そとまわり	外回り
そなえ	供え
そなえ	備え
そなえつけ	備え付け
そなわ	備わ
そね	嫉
その	園
その	其
そのご	その後
そのた	その他
そのよう	その様
そば	蕎麦
そば	側
そばこ	そば粉
そばこ	蕎麦粉
そびえた	そびえ立
そびょう	素描
そふ	祖父
そふぼ	祖父母
そぼ	祖母
そほう	粗放
そぼう	粗暴
そほうか	素封家
そぼく	素朴
そま	染ま
そまつ	粗末
そむ	背
そめ	初め
そめ	染め
そめだ	染め出
そめつけ	染め付け
そめもの	染物
そや	粗野
そよう	素養
そようちょう	租庸調
そよかぜ	そよ風
そら	逸
そら	逸ら
そら	空
そら	反ら
そらおそろし	そら恐ろし
そらなみだ	空涙
そらに	空似
そりかえ	反り返
そりゃく	粗略
そりゅうし	素粒子
それ	逸れ
それぞれ	其々
それぞれ	夫々
そろ	揃
そろえ	揃え
そん	存
そん	損
そん	村
ぞん	存
そんえい	村営
そんえき	損益
そんかい	損壊
そんがい	損害
ぞんがい	存外
そんけい	尊敬
そんげん	尊厳
そんざい	存在
ぞんじあげ	存じ上げ
そんしつ	損失
そんしょう	尊称
そんしょう	損傷
そんしょく	遜色
そんぞく	存続
そんぞく	尊属
そんだい	尊大
そんたく	忖度
そんち	存置
そんちょう	尊重
そんちょう	村長
そんとく	損得
ぞんぶん	存分
そんぼう	存亡
そんみん	村民
ぞんめい	存命
そんもう	損耗
そんらく	村落
そんりつ	存立
そんりつ	村立
た	起
た	経
た	建
た	裁
た	炊
た	絶
た	足
た	他
た	断
た	田
た	発
た	焚
た	立
だ	出
だ	田
だ	抱
たあい	他愛
たあいな	他愛な
たい	他意
たい	体
たい	対
たい	帯
たい	隊
たい	鯛
だい	代
だい	台
だい	大
だい	題
たいあたり	体当り
たいあん	対案
たいあん	大安
だいあん	代案
たいい	体位
たいい	退位
たいい	大意
たいいき	帯域
たいいき	大域
たいいきち	大域値
たいいく	体育
たいいくかん	体育館
だいいち	第一
たいいん	退院
たいいん	隊員
たいえい	退嬰
たいえき	体液
たいえき	退役
だいえん	大円
たいおう	対応
だいおうじょう	大往生
たいおん	体温
たいか	耐火
たいか	滞貨
たいか	退化
たいか	大家
たいか	大火
たいか	大過
たいが	大河
だいか	代価
たいかい	退会
たいかい	大会
たいかい	大海
たいがい	体外
たいがい	対外
たいがい	大概
だいがえ	代替
たいかく	体格
たいかく	対格
たいがく	退学
だいがく	大学
だいがくいん	大学院
だいがくせい	大学生
たいかくせん	対角線
たいかん	耐寒
たいかん	戴冠
たいかん	退官
たいがん	対岸
だいかん	代官
だいかん	大寒
たいかんしき	戴冠式
たいき	待機
たいき	大気
たいきけん	大気圏
だいきぼ	大規模
たいぎめいぶん	大義名分
たいきゃく	退却
たいきゅう	耐久
だいきゅう	代休
たいきょ	退去
たいきょ	大挙
たいきょう	胎教
たいきょく	太極
たいきょく	対局
たいきょく	対極
たいきょく	大局
たいきょくけん	太極拳
たいきん	大金
だいきん	代金
たいく	体躯
だいく	大工
たいくう	滞空
たいぐう	対偶
たいぐう	待遇
たいくつ	退屈
たいぐん	大群
たいけい	体型
たいけい	体系
たいけい	大慶
だいけい	台形
たいけつ	対決
たいけん	体験
たいけん	大圏
たいげん	体現
たいげん	体言
たいこ	太古
たいこ	太鼓
たいこう	対抗
たいこう	退行
たいこう	大公
たいこう	大綱
だいこう	代行
だいこう	代講
たいこく	大国
だいこく	大黒
たいこしょう	耐故障
たいこばら	太鼓腹
たいこばん	太鼓判
だいごみ	醍醐味
だいこん	大根
たいさ	大佐
たいさ	大差
たいざ	対座
たいざい	滞在
だいざい	題材
たいさく	対策
たいさく	大作
たいさん	退散
たいし	太子
たいし	大使
たいし	大志
たいじ	対峙
たいじ	胎児
たいじ	退治
だいし	台紙
だいじ	大事
だいじ	題字
たいしかん	大使館
たいした	大した
たいしつ	体質
たいしゃ	退社
たいしゃ	代謝
たいしゃ	大赦
だいしゃ	台車
たいしゃく	貸借
たいじゅ	大樹
たいしゅう	体臭
たいしゅう	大衆
たいじゅう	体重
だいしゅくしゃく	大縮尺
たいしゅつ	退出
たいしょ	対処
たいしょ	大暑
だいしょ	代書
たいしょう	対照
たいしょう	対症
たいしょう	対称
たいしょう	対象
たいしょう	大勝
たいしょう	大将
たいしょう	大賞
たいじょう	退場
だいしょう	代償
だいしょう	大小
たいしょうがい	対象外
だいじょうぶ	大丈夫
たいしょく	退職
たいしょく	大食
たいしょく	褪色
たいしょくかん	大食漢
たいしょくきん	退職金
たいしん	耐震
たいじん	対人
だいじん	大臣
だいず	大豆
たいすい	耐水
だいすう	代数
だいすう	台数
だいすき	大好き
たいせい	体制
たいせい	体勢
たいせい	耐性
たいせい	態勢
たいせい	大勢
たいせい	大成
たいせき	体積
たいせき	堆積
たいせき	滞積
たいせき	退席
たいせつ	大切
たいせつ	大雪
だいせつ	大雪
たいせん	対戦
たいせん	大戦
たいぜん	泰然
たいそう	体操
たいそう	大喪
たいそう	大層
たいぞう	退蔵
たいそく	体側
だいそれた	大それた
たいだ	怠惰
だいたい	代替
だいたい	大体
だいたい	大隊
だいだい	代々
だいだい	橙
だいだいてき	大々的
たいだん	対談
たいだん	退団
だいたん	大胆
たいち	対地
たいち	対置
だいち	台地
だいち	大地
たいちょ	大著
たいちょう	体調
たいちょう	体長
たいちょう	隊長
だいちょう	台帳
だいちょう	大腸
たいてい	大抵
たいてき	大敵
たいでん	帯電
たいと	泰斗
たいど	態度
たいとう	対等
たいとう	帯刀
たいとう	台頭
たいどう	胎動
だいとうりょう	大統領
たいとく	体得
だいどころ	台所
たいない	体内
たいない	対内
たいない	胎内
だいなごん	大納言
だいなし	台無し
だいに	第二
たいにち	対日
たいにち	滞日
だいにゅう	代入
たいにん	退任
たいにん	大任
たいねつ	耐熱
たいのう	滞納
だいのう	代納
だいのう	大脳
だいのうかい	大納会
たいは	大破
たいはい	頽廃
たいばつ	体罰
だいはっかい	大発会
たいはん	大半
たいばん	胎盤
たいひ	堆肥
たいひ	対比
たいひ	退避
だいひつ	代筆
たいびょう	大病
だいひょう	代表
たいぶ	大部
だいぶ	大分
たいふう	台風
だいふく	大福
だいふくちょう	大福帳
たいぶつ	対物
だいぶつ	大仏
だいぶぶん	大部分
だいぶん	大分
たいへい	太平
たいべい	対米
たいべつ	大別
たいへん	大変
だいべん	代弁
だいべん	大便
たいほ	退歩
たいほ	逮捕
たいほう	大砲
たいほう	大鵬
たいぼう	耐乏
たいぼう	待望
たいぼう	大望
たいぼく	大木
だいほん	台本
たいま	タイマ
たいま	大麻
たいまい	大枚
たいまん	怠慢
だいみょう	大名
だいめい	題名
だいめいし	代名詞
たいめん	体面
たいめん	対面
たいもう	体毛
だいもく	題目
だいもん	代紋
だいもん	大門
たいやく	対訳
たいやく	大役
だいやく	代役
たいよ	貸与
たいよう	太陽
たいよう	耐用
たいよう	大洋
たいよう	大要
だいよう	代用
たいようけい	太陽系
たいら	平
たいら	平ら
たいらげ	平らげ
だいり	代理
だいり	内裏
たいりく	大陸
だいりせき	大理石
たいりつ	対立
だいりてん	代理店
たいりゃく	大略
たいりゅう	対流
たいりゅう	滞留
たいりょう	大量
たいりょく	体力
たいりん	大輪
たいろう	大老
たいわ	対話
たう	多雨
たえ	堪え
たえ	絶え
たえ	耐え
だえき	唾液
たえず	絶えず
たえなる	妙なる
たえま	絶えま
たえま	絶え間
だえん	楕円
だえんこ	楕円弧
たお	倒
たおれ	倒れ
たか	高
たか	多寡
たか	鷹
たが	違
たかい	他界
たがい	互い
だかい	打開
たがいちがい	互い違い
たかく	多角
たがく	多額
たかくけい	多角形
たかくすい	多角錐
たかくすいだい	多角錐台
たかくちゅう	多角柱
たかさご	高砂
たかしお	高潮
たかだい	高台
たかだか	高々
たかっけい	多角形
たかとび	高飛び
たかな	高鳴
たかなみ	高波
たかね	高値
たがね	鏨
たかのぞみ	高望み
たかぶ	昂ぶ
たかぶ	亢ぶ
たかま	高ま
たかめ	高め
たがや	耕
たから	宝
たからか	高らか
たからじま	宝島
たからもの	宝物
たかん	多感
たき	多岐
たき	滝
たき	瀧
だき	唾棄
たきがわ	滝川
たきぎ	薪
だきこ	抱き込
だきしめ	抱きしめ
だきしめ	抱き締め
たきだし	炊出し
たきび	焚火
たきょう	他郷
だきょう	妥協
たきょく	他局
たきょく	多極
たく	宅
たく	托
たく	託
たぐ	手繰
だく	諾
たぐい	類
たくいつ	択一
たくえつ	卓越
だくおん	濁音
たくさん	沢山
たくじ	託児
たくしゅつ	卓出
たくじょう	卓上
たくしょく	拓殖
だくすい	濁水
たくせつ	卓説
たくせん	託宣
たくそう	託送
たくち	宅地
だくてん	濁点
たくはい	宅配
たくはつ	托鉢
たくばつ	卓抜
たくほん	拓本
たくまし	逞し
たくみ	巧み
たくみ	匠
たくら	企
だくりゅう	濁流
たくわえ	蓄え
たくわえ	貯え
たけ	岳
たけ	丈
たけ	他家
たけ	竹
たけ	長け
たけ	猛
たげい	多芸
だげき	打撃
だけつ	妥結
たけばやし	竹林
たけひご	竹ひご
たけん	他県
たげん	多元
たげん	多言
だけん	打鍵
たこ	凧
たこ	蛸
たこ	鮹
たこう	他校
たこう	多幸
だこう	蛇行
たこうしき	多項式
たこく	他国
たごん	他言
たざ	打坐
たさい	多彩
たさい	多才
たさく	多作
ださく	駄作
たさつ	他殺
ださん	打算
たざんのいし	他山の石
たし	足し
たし	他紙
たし	他誌
たじ	他事
たじ	多事
だし	山車
だし	出汁
だしあ	出し合
だしいれ	出し入れ
たしか	確か
たしかめ	確かめ
だしき	出し切
たしざん	足し算
たしざん	足算
たしつ	多湿
たじつ	他日
だしぬ	出し抜
だしもの	出し物
たしゃ	他社
たしゃ	他者
たしゃ	多謝
だしゃ	打者
だじゃく	懦弱
だじゃれ	駄洒落
たしゅ	他種
たしゅ	多種
たじゅう	多重
たしゅつ	他出
だじゅん	打順
たしょう	他生
たしょう	多少
たしょう	多祥
たじょう	多情
だしん	打診
たすう	多数
たすうけつ	多数決
たすか	助か
たすけ	助け
たすけあ	助け合
たすけだ	助け出
たずさえ	携え
たずさわ	携わ
たずね	尋ね
たずね	訪ね
たぜい	多勢
だせい	惰性
だせき	打席
たせん	他薦
だそく	蛇足
たた	畳
たた	多々
たた	叩
たた	祟
ただ	質
ただ	正
ただ	只
たたい	多体
ただい	多大
ただいま	ただ今
ただいま	只今
たたえ	讃え
たたえ	称え
たたえ	湛え
たたか	戦
たたか	闘
たたきこ	たたき込
たたきだ	たたき出
ただごと	唯事
ただし	正し
ただし	但
ただし	但し
ただしがき	但書き
ただちに	直ちに
たたみ	畳
たたみかけ	畳み掛け
たたみこ	畳み込
ただよ	漂
ただよわ	漂わ
たち	質
たち	多値
たち	太刀
たちあ	立ち会
たちあいにん	立会人
たちあが	立ち上が
たちあがり	立上り
たちあげ	立ち上げ
たちい	立ち居
たちい	立ち入
たちい	立居
たちうり	立売
たちおうじょう	立往生
たちおくれ	立ち後れ
たちき	断ち切
たちぎえ	立ち消え
たちぎき	立ち聞き
たちぐい	立ち食い
たちさ	立ち去
たちすく	立ちすく
たちどま	立ち止ま
たちなお	立ち直
たちなら	建ち並
たちなら	立ち並
たちの	立ち退
たちば	立場
たちはだか	立ちはだか
たちばな	橘
たちばなし	立ち話
たちまち	立待ち
たちまわ	立ち回
たちみ	立見
たちむか	立ち向か
たちよ	立ち寄
だちょう	駝鳥
だちん	駄賃
たっ	達
たつ	辰
たつ	竜
たつ	龍
だっ	脱
だつ	建つ
だつい	脱衣
だっかい	奪回
だっかい	脱会
だっかく	奪格
だっきゃく	脱却
たっきゅう	卓球
だっきゅう	脱臼
たっきゅうびん	宅急便
たっけん	卓見
だっこう	脱稿
だっこう	脱肛
だっこく	脱穀
だつごく	脱獄
だっし	脱脂
だつじ	脱字
たっしゃ	達者
だっしゅう	脱臭
だっしゅつ	脱出
だっしょく	脱色
たつじん	達人
だっすい	脱水
たっせい	達成
だつぜい	脱税
だっせん	脱線
だっそう	脱走
だったい	脱退
たっち	タッチ
だっちゃく	脱着
だっちょう	脱腸
たっと	貴
たっと	尊
たつどし	辰年
たづな	手綱
だっぴ	脱皮
たっぴつ	達筆
たつぶん	達文
だつぼう	脱帽
たつまき	竜巻
たつみ	巽
だつもう	脱毛
だつらく	脱落
だつりゃく	奪略
たて	館
たて	舘
たて	建て
たて	縦
たて	楯
たて	盾
たて	点て
たて	立て
たで	蓼
だて	伊達
だて	立て
たてうち	館内
たてうり	建売り
たてかえ	建て替え
たてかえ	立て替え
たてかえ	立替
たてかけ	立てかけ
たてこ	たて込
たてこも	立てこも
たてじま	縦縞
たてつ	盾突
たてつけ	建てつけ
たてつけ	立付け
たてつぼ	建坪
たてなが	縦長
たてまえ	建前
だてまき	伊達巻
たてまし	建増し
たてまつ	奉
たてもの	建物
たてや	建屋
たてやくしゃ	立役者
だでん	打電
たど	辿
だとう	妥当
だとう	打倒
たどうし	他動詞
だとうせい	妥当性
たとえ	例え
たとえば	例えば
たどく	多読
たどりつ	たどり着
たな	棚
たな	店
たなあげ	棚上げ
たないた	棚板
たなおろし	棚卸し
たなごころ	掌
たなざらし	店ざらし
たなざらし	店晒し
たなばた	七夕
たなび	棚引
たなん	多難
たに	谷
だに	谷
たにがわ	谷川
たにま	谷間
たにん	他人
たぬき	狸
たね	胤
たね	種
たねあかし	種明かし
たねあかし	種明し
たねん	多年
たの	頼
たのう	多能
たのし	楽し
たのし	愉し
たのみこ	頼み込
たのもし	頼もし
たば	束
だは	打破
たばい	多売
たばか	謀
たばこ	煙草
たはつ	多発
たばね	束ね
たび	足袋
たび	度
たび	旅
だび	荼毘
たびかさな	度重な
たびさき	旅先
たびじ	旅路
たびだ	旅立
たびたび	度々
たびびと	旅人
たぶん	他聞
たぶん	多分
たべ	食べ
たべもの	食べ物
たべん	多弁
だほ	拿捕
たほう	他方
たぼう	多忙
たほうせい	多峰性
だぼく	打撲
たま	丸
たま	球
たま	給
たま	玉
たま	賜
たま	珠
たま	弾
たま	貯
たま	溜
だま	黙
たまげ	魂消
たまご	玉子
たまご	卵
たましい	魂
だましと	だまし取
たまつき	球撞き
たまてばこ	玉手箱
たまねぎ	玉葱
たまのこし	玉の輿
たまむし	玉虫
たまもの	賜
たまり	溜
だまり	溜り
たまわ	賜
たまわ	賜わ
たみ	民
だみごえ	だみ声
たむし	田虫
たむろ	屯
ため	為
ため	矯め
ため	試
ため	貯め
ため	溜
ため	溜め
だめ	駄目
だめ	溜め
ためいき	ため息
ためし	例
ためん	他面
ためん	多面
ためんたい	多面体
たもつ	保
たや	絶や
たやす	容易
たよ	頼
たよう	多様
たよう	多用
たより	便り
たよりな	頼りな
たら	垂ら
たら	鱈
だらく	堕落
たり	足り
たりき	他力
たりゅうじあい	他流試合
たりょう	多量
だりょく	惰力
たる	樽
たれ	垂れ
だれ	誰
たれさが	垂れ下が
だれしも	誰しも
たわごと	戯言
たわむれ	戯れ
たわら	俵
たん	単
たん	嘆
たん	短
たん	胆
たん	反
だん	団
だん	壇
だん	弾
だん	断
だん	暖
だん	段
だん	談
だんあつ	弾圧
たんい	単位
たんいつ	単一
たんいつか	単一化
たんか	単価
たんか	担架
たんか	炭化
たんか	短歌
たんか	啖呵
だんかい	団塊
だんかい	段階
だんがい	弾劾
だんがい	断崖
たんがん	嘆願
だんがん	弾丸
たんき	短期
たんき	短気
だんき	暖気
だんぎ	談義
だんぎ	談議
たんきゅう	探求
たんきゅう	探究
たんく	短躯
たんげい	端倪
だんけつ	団結
たんけん	探検
たんけん	探険
たんげん	単元
だんげん	断言
たんご	単語
だんこ	断固
だんご	団子
たんこう	単行
たんこう	炭坑
たんこう	炭鉱
だんこう	団交
だんこう	断交
だんこう	断行
だんごう	談合
だんごばな	だんご鼻
だんこん	弾痕
だんこん	男根
たんさ	探査
たんざ	端座
だんさ	段差
たんさい	淡彩
だんさい	断裁
たんさく	探索
たんざく	短冊
たんさん	炭酸
たんし	端子
だんし	男子
だんじ	男児
たんじかん	短時間
だんじき	断食
だんじて	断じて
たんしゃ	単車
だんしゃく	男爵
たんじゅう	短銃
たんじゅう	胆汁
たんしゅく	短縮
たんじゅん	単純
たんしょ	短所
たんしょ	端緒
だんじょ	男女
たんしょう	探勝
たんしょう	短小
たんじょう	誕生
だんしょう	談笑
だんじょう	壇上
たんじょうび	誕生日
たんしん	単身
たんしん	短針
たんす	箪笥
たんすい	淡水
たんすう	単数
たんせい	丹精
たんせい	丹青
たんせい	端正
だんせい	弾性
だんせい	男性
だんせい	男声
だんせいたい	弾性体
たんせき	胆石
だんぜつ	断絶
たんせん	単線
たんぜん	丹前
たんぜん	端然
だんせん	断線
だんぜん	断然
たんそ	炭素
たんぞう	鍛造
だんそう	断層
たんそく	嘆息
たんそく	短足
だんぞく	断続
たんたい	単体
たんだい	短大
だんたい	団体
たんたん	淡々
だんだん	段々
たんち	探知
だんち	団地
だんちがい	段違い
だんちゃく	弾着
たんちょう	丹頂
たんちょう	単調
たんちょう	短調
だんちょう	団長
だんちょう	断腸
たんちょうづる	丹頂鶴
たんてい	探偵
だんてい	断定
たんてき	端的
たんでき	耽溺
たんてん	端点
たんでん	炭田
たんとう	担当
たんとう	短刀
だんとう	弾頭
だんとう	暖冬
だんどう	弾道
たんとうしゃ	担当者
だんとうだい	断頭台
たんとうちょくにゅう	単刀直入
たんどく	丹毒
たんどく	単独
だんとつ	断トツ
だんどり	段取り
だんな	旦那
たんなる	単なる
たんにん	担任
だんねつざい	断熱材
たんねん	丹念
だんねん	断念
たんのう	堪能
たんのう	胆嚢
たんぱ	短波
たんぱく	淡白
たんぱく	蛋白
だんぱつ	断髪
たんび	耽美
たんぴょう	短評
たんぴん	単品
たんぷく	単複
たんぶん	単文
たんぶん	短文
たんぺん	短篇
たんぺん	短編
たんぺん	短辺
だんぺん	断片
たんぼ	田んぼ
たんぼ	田圃
たんぽ	担保
たんぼう	探訪
だんぼう	暖房
たんぽぽ	蒲公英
たんまつ	端末
たんむ	坦務
だんめん	断面
たんもの	反物
だんゆう	男優
たんようき	単葉機
たんらく	短絡
だんらく	段落
だんりゅう	暖流
たんりょく	胆力
だんりょく	弾力
たんれい	端麗
たんれん	鍛錬
だんろ	暖炉
だんわ	談話
ち	血
ち	散
ち	治
ち	値
ち	知
ち	地
ぢ	痔
ちあん	治安
ちい	地位
ちい	地衣
ちいき	地域
ちいさ	小さ
ちいさな	小さな
ちえ	知恵
ちえぶくろ	知恵袋
ちえん	地縁
ちえん	遅延
ちか	近
ちか	誓
ちか	地下
ちか	地価
ちが	違
ちかい	地階
ちがいな	違いな
ちがえ	違え
ちかく	近く
ちかく	知覚
ちかく	地殻
ちがく	地学
ちかけい	地下茎
ちかごろ	近頃
ちかし	近し
ちかしつ	地下室
ちかぢか	近々
ちかぢかと	近々と
ちかぢかの	近々の
ちかづ	近付
ちかづけ	近づけ
ちかづけ	近付け
ちかてつ	地下鉄
ちかば	近場
ちかみち	近道
ちかよ	近寄
ちから	力
ちからぞえ	力添え
ちからづよ	力強
ちからぶそく	力不足
ちからもち	力持ち
ちからわざ	力業
ちかん	痴漢
ちかん	置換
ちき	知己
ちきゅう	地球
ちきゅうぎ	地球儀
ちぎり	契
ちく	地区
ちくいち	逐一
ちぐさ	千草
ちくさん	畜産
ちくじ	逐次
ちくじょう	築城
ちくせき	蓄積
ちくぞう	築造
ちくでん	蓄電
ちくでんき	蓄電器
ちくねん	逐年
ちくのう	蓄膿
ちくろく	逐鹿
ちけい	地形
ちけん	知見
ちご	稚児
ちこく	遅刻
ちさい	地裁
ちさん	遅参
ちし	致死
ちじ	知事
ちしお	血潮
ちしき	知識
ちじく	地軸
ちしつ	地質
ちじょう	地上
ちじょう	痴情
ちじょく	恥辱
ちじん	知人
ちず	地図
ちすい	治水
ちすじ	血筋
ちせい	知性
ちせつ	稚拙
ちそう	地層
ちそう	馳走
ちたい	地帯
ちたい	遅滞
ちだい	地代
ちち	遅々
ちち	乳
ちち	父
ちぢ	縮
ちちおや	父親
ちちばなれ	乳離れ
ちぢま	縮ま
ちちゅう	地中
ちつ	膣
ちっきょ	蟄居
ちつじょ	秩序
ちっそ	窒素
ちっそく	窒息
ちてい	地底
ちてき	知的
ちてん	地点
ちどうせつ	地動説
ちとせ	千歳
ちどり	千鳥
ちな	因
ちなみに	因みに
ちにちは	知日派
ちねつ	地熱
ちのう	知能
ちはい	遅配
ちばし	血走
ちばん	地番
ちひょう	地表
ちぶ	恥部
ちぶさ	乳房
ちへい	地平
ちへん	地変
ちほう	地方
ちほう	痴呆
ちほうさい	地方債
ちまき	粽
ちまた	巷
ちまよ	血迷
ちみつ	緻密
ちみもうりょう	魑魅魍魎
ちめい	知名
ちめい	知命
ちめい	地名
ちめい	致命
ちめいど	知名度
ちゃ	茶
ちゃーはん	炒飯
ちゃいろ	茶色
ちゃき	茶器
ちゃく	着
ちゃくい	着衣
ちゃくがん	着眼
ちゃくし	嫡子
ちゃくじつ	着実
ちゃくしゅ	着手
ちゃくしゅつ	嫡出
ちゃくしょく	着色
ちゃくすい	着水
ちゃくせい	着生
ちゃくせき	着席
ちゃくそう	着想
ちゃくだつ	着脱
ちゃくち	着地
ちゃくちゃく	着々
ちゃくにん	着任
ちゃくばらい	着払
ちゃくふく	着服
ちゃくもく	着目
ちゃくよう	着用
ちゃくりく	着陸
ちゃくりゅう	嫡流
ちゃしゃく	茶杓
ちゃせん	茶筅
ちゃっか	着火
ちゃっかん	着艦
ちゃっこう	着工
ちゃのま	茶の間
ちゃばん	茶番
ちゃや	茶屋
ちゃわん	茶碗
ちゆ	治癒
ちゅう	沖
ちゅう	中
ちゅう	宙
ちゅう	忠
ちゅう	注
ちゅうい	注意
ちゅういぶか	注意深
ちゅういほう	注意報
ちゅうおう	中央
ちゅうか	中華
ちゅうかい	仲介
ちゅうかい	注解
ちゅうがい	虫害
ちゅうがえり	宙返り
ちゅうかく	中核
ちゅうがく	中学
ちゅうがくせい	中学生
ちゅうがた	中型
ちゅうがっこう	中学校
ちゅうから	中辛
ちゅうかん	中間
ちゅうかんし	中間子
ちゅうき	中期
ちゅうき	抽気
ちゅうき	注記
ちゅうぎ	忠義
ちゅうきぼ	中規模
ちゅうきゅう	中級
ちゅうきょり	中距離
ちゅうきん	忠勤
ちゅうくう	中空
ちゅうけい	中継
ちゅうけん	中堅
ちゅうけん	中研
ちゅうげん	中元
ちゅうこ	中古
ちゅうこうせい	中高生
ちゅうこうねん	中高年
ちゅうこく	忠告
ちゅうごし	中腰
ちゅうさ	中佐
ちゅうざ	中座
ちゅうさい	仲裁
ちゅうざい	駐在
ちゅうし	中止
ちゅうし	注視
ちゅうじ	中耳
ちゅうじつ	忠実
ちゅうしゃ	注射
ちゅうしゃ	駐車
ちゅうしゃく	注釈
ちゅうしゃじょう	駐車場
ちゅうしゅう	仲秋
ちゅうしゅつ	抽出
ちゅうじゅん	中旬
ちゅうしょう	中傷
ちゅうしょう	中小
ちゅうしょう	抽象
ちゅうじょう	中将
ちゅうしょく	昼食
ちゅうしん	中心
ちゅうしん	中震
ちゅうしん	忠臣
ちゅうしん	衷心
ちゅうすい	注水
ちゅうすい	虫垂
ちゅうすう	中枢
ちゅうせい	中世
ちゅうせい	中性
ちゅうせい	忠誠
ちゅうせいし	中性子
ちゅうぜつ	中絶
ちゅうせん	抽選
ちゅうぞう	鋳造
ちゅうそく	中速
ちゅうそつ	中卒
ちゅうたい	中退
ちゅうたい	中隊
ちゅうだん	中断
ちゅうちょ	躊躇
ちゅうっぱら	中っ腹
ちゅうてつ	鋳鉄
ちゅうてん	中天
ちゅうてん	中点
ちゅうと	中途
ちゅうとう	中等
ちゅうどく	中毒
ちゅうなごん	中納言
ちゅうにち	駐日
ちゅうにゅう	注入
ちゅうねん	中年
ちゅうのう	中濃
ちゅうばつ	誅伐
ちゅうばん	中盤
ちゅうぶ	中部
ちゅうぶう	中風
ちゅうふく	中腹
ちゅうぶん	中文
ちゅうぼう	厨房
ちゅうもく	注目
ちゅうもん	中門
ちゅうもん	注文
ちゅうや	昼夜
ちゅうよう	中庸
ちゅうりつ	中立
ちゅうりゃく	中略
ちゅうりゅう	中流
ちゅうりょく	注力
ちゅうわ	中和
ちょ	著
ちよ	千代
ちょう	兆
ちょう	喋
ちょう	寵
ちょう	帳
ちょう	庁
ちょう	弔
ちょう	徴
ちょう	朝
ちょう	町
ちょう	腸
ちょう	蝶
ちょう	長
ちょうあい	寵愛
ちょうい	弔意
ちょうい	弔慰
ちょういん	調印
ちょうえい	町営
ちょうえき	懲役
ちょうえつ	超越
ちょうおん	聴音
ちょうおん	長音
ちょうおんぱ	超音波
ちょうか	超過
ちょうかい	懲戒
ちょうかい	朝会
ちょうかい	町会
ちょうかい	聴解
ちょうかいりょく	聴解力
ちょうかく	聴覚
ちょうかん	朝刊
ちょうかん	長官
ちょうかん	鳥瞰
ちょうき	弔旗
ちょうき	長期
ちょうきょう	調教
ちょうきょうし	調教師
ちょうきょり	長距離
ちょうきん	彫金
ちょうきん	超勤
ちょうけい	長径
ちょうけし	帳消し
ちょうげん	調弦
ちょうこう	兆候
ちょうこう	聴講
ちょうこう	調香
ちょうこう	長考
ちょうごう	調号
ちょうごう	調合
ちょうこうぜつ	長広舌
ちょうこうそく	超高速
ちょうこく	彫刻
ちょうこく	超克
ちょうこくとう	彫刻刀
ちょうさ	調査
ちょうさん	逃散
ちょうし	調子
ちょうし	銚子
ちょうし	長子
ちょうじ	弔辞
ちょうじかん	長時間
ちょうしゃ	庁舎
ちょうじゃ	長者
ちょうしゅ	聴取
ちょうじゅ	長寿
ちょうしゅう	徴収
ちょうしゅう	聴衆
ちょうしょ	調書
ちょうしょ	長所
ちょうじょ	長女
ちょうしょう	弔鐘
ちょうしょう	長嘯
ちょうしょう	嘲笑
ちょうじょう	重畳
ちょうじょう	頂上
ちょうしょく	朝食
ちょうじり	帳尻
ちょうしん	長身
ちょうしん	長針
ちょうじん	超人
ちょうしんき	聴診器
ちょうせい	調整
ちょうせい	調製
ちょうせいき	調整器
ちょうせつ	調節
ちょうせん	挑戦
ちょうぜん	超然
ちょうぞう	彫像
ちょうそん	町村
ちょうそん	長孫
ちょうだい	長大
ちょうだい	頂戴
ちょうたく	彫琢
ちょうたつ	調達
ちょうたん	長短
ちょうちゃく	打擲
ちょうちょう	喋々
ちょうちょう	町長
ちょうちょう	蝶々
ちょうちょう	長調
ちょうちょうはっし	打々発止
ちょうてい	朝廷
ちょうてい	調停
ちょうてん	頂点
ちょうでん	弔電
ちょうでんどう	超電導
ちょうど	丁度
ちょうど	調度
ちょうどきゅう	超弩級
ちょうない	町内
ちょうなん	長男
ちょうは	長波
ちょうば	帳場
ちょうはつ	徴発
ちょうはつ	挑発
ちょうばつ	懲罰
ちょうひょう	帳票
ちょうふく	重複
ちょうぶつ	長物
ちょうぶん	長文
ちょうへい	徴兵
ちょうへん	長編
ちょうへん	長辺
ちょうぼ	帳簿
ちょうほう	重宝
ちょうほう	諜報
ちょうほうけい	長方形
ちょうほんにん	張本人
ちょうみ	調味
ちょうみりょう	調味料
ちょうみん	町民
ちょうめ	丁目
ちょうめん	帳面
ちょうもく	鳥目
ちょうもん	弔問
ちょうやく	跳躍
ちょうよう	徴用
ちょうらく	凋落
ちょうり	調理
ちょうりつ	町立
ちょうりつ	調律
ちょうりゅう	潮流
ちょうりょう	跳梁
ちょうりょく	張力
ちょうりょく	潮力
ちょうりょく	聴力
ちょうれい	朝礼
ちょうれいぼかい	朝令暮改
ちょうろう	長老
ちょうろう	嘲弄
ちょうわ	調和
ちょきん	貯金
ちょくえい	直営
ちょくげき	直撃
ちょくご	勅語
ちょくご	直後
ちょくさい	直截
ちょくし	直視
ちょくしゃ	直射
ちょくじょう	直情
ちょくじょうけいこう	直情径行
ちょくしん	直進
ちょくせつ	直接
ちょくせつ	直截
ちょくせん	直線
ちょくぜん	直前
ちょくそう	直送
ちょくぞく	直属
ちょくつう	直通
ちょくとう	直答
ちょくばい	直売
ちょくはん	直販
ちょくほうたい	直方体
ちょくめい	勅命
ちょくめん	直面
ちょくやく	直訳
ちょくりつ	直立
ちょくりゅう	直流
ちょくれつ	直列
ちょこ	猪口
ちょさく	著作
ちょしゃ	著者
ちょじゅつ	著述
ちょしょ	著書
ちょすいち	貯水池
ちょぞう	貯蔵
ちょちく	貯蓄
ちょっか	直下
ちょっかく	直角
ちょっかつ	直轄
ちょっかん	直感
ちょっかん	直観
ちょっき	直帰
ちょっけい	直径
ちょっけい	直系
ちょっけつ	直結
ちょっこう	直交
ちょっこう	直行
ちょとつもうしん	猪突猛進
ちょめい	著名
ちょめい	著明
ちら	散ら
ちらか	散らか
ちらば	散らば
ちり	塵
ちり	地理
ちりばめ	散りばめ
ちりょう	治療
ちわ	痴話
ちん	朕
ちん	珍
ちん	陳
ちんあげ	賃上げ
ちんあつ	鎮圧
ちんか	沈下
ちんか	鎮火
ちんき	珍奇
ちんきゃく	珍客
ちんぎん	賃金
ちんこう	沈降
ちんざ	鎮座
ちんさげ	賃下げ
ちんじ	珍事
ちんしゃ	陳謝
ちんしゃく	賃借
ちんじゅ	鎮守
ちんじゅつ	陳述
ちんじょう	陳情
ちんせい	鎮静
ちんたい	沈滞
ちんたい	賃貸
ちんだん	珍談
ちんちょう	珍重
ちんつう	鎮痛
ちんでん	沈殿
ちんでん	沈澱
ちんとう	枕頭
ちんぷ	陳腐
ちんぽこ	似指
ちんぼつ	沈没
ちんみ	珍味
ちんもく	沈黙
ちんれつ	陳列
つ	詰
つ	継
つ	嗣
つ	次
つ	就
つ	衝
つ	積
つ	接
つ	着
つ	注
つ	津
つ	吊
つ	釣
つ	摘
つ	撞
つ	突
つ	付
つ	附
づ	津
つい	対
ついおく	追憶
ついか	追加
ついかんばん	椎間板
ついき	追記
ついきゅう	追及
ついきゅう	追求
ついきゅう	追究
ついげき	追撃
ついし	墜死
ついし	追試
ついしけん	追試験
ついじゅう	追従
ついしょう	追従
ついしん	追伸
ついずい	追随
ついせき	追跡
ついそ	追訴
ついたち	1日
ついたち	１日
ついたち	一日
ついちょう	追徴
ついとう	追悼
ついとつ	追突
ついに	遂に
ついにん	追認
ついば	啄
ついほう	追放
ついや	費や
ついらく	墜落
ついろく	追録
つう	通
つういん	通院
つうえん	通園
つうか	通貨
つうか	通過
つうかい	痛快
つうかく	痛覚
つうがく	通学
つうかん	痛感
つうかん	通巻
つうかん	通関
つうき	通気
つうきん	通勤
つうげき	痛撃
つうこう	通行
つうこうどめ	通行止
つうこく	痛哭
つうこく	通告
つうこん	痛恨
つうさん	通産
つうさん	通算
つうさんしょう	通産相
つうし	通史
つうじ	通時
つうしょう	通商
つうしょう	通称
つうじょう	通常
つうしん	通信
つうしんもう	通信網
つうせつ	痛切
つうせつ	通説
つうそう	通奏
つうぞく	通俗
つうたつ	通達
つうち	通知
つうちょう	通帳
つうてん	痛点
つうでん	通電
つうどく	通読
つうねん	通念
つうふう	通風
つうほう	通報
つうやく	通訳
つうよう	通用
つうれい	通例
つうれつ	痛烈
つうろ	通路
つうわ	通話
つえ	杖
つか	遣
つか	使
つか	浸か
つか	塚
つか	掴
つか	漬か
づか	塚
つがい	番
つかいがって	使い勝手
つかいこ	使い込
つかいこな	使いこな
つかいわけ	使い分け
つかえ	仕え
つかさど	司
つかのま	束の間
つかま	捕ま
つかまえ	捕まえ
つかみあ	つかみ合
つかれ	疲れ
つき	月
つき	尽き
つき	付き
つぎ	次
つきあ	つき合
つきあ	付き合
つきあげ	突き上げ
つきあわせ	突き合わせ
つきがけ	月掛け
つきぎめ	月極め
つきぎり	月切
つきぎり	月切り
つきさ	突き刺
つきすす	突き進
つきそ	付き添
つきそい	付添
つきそい	付添い
つきだ	突き出
つぎた	継ぎ足
つきづき	月々
つぎつぎ	次々
つきつけ	突き付け
つきつめ	突き詰め
つきとめ	突き止め
つきはな	突き放
つきばらい	月払い
つきひ	月日
つきべつ	月別
つきまと	付きまと
つきみ	月見
つぎめ	継目
つきやま	築山
つきよ	月夜
つく	作
つく	尽く
つく	創
つく	造
つくえ	机
づくえ	机
つくだ	佃
つくだに	佃煮
つぐな	償
つぐみ	鶫
つくり	作り
つくりあげ	作り上げ
つくりあげ	造り上げ
つくりかた	作り方
つくりだ	つくり出
つくりだ	作り出
つくりだ	創り出
つくろ	繕
つけ	漬け
つけ	点け
つけ	付け
つげ	告げ
つげ	柘植
つけかえ	付け替え
つけかた	付け方
つげぐち	告げ口
つけくわえ	付け加え
つけこ	漬け込
つけこ	付け込
つけた	付け足
つけねら	付け狙
つけもの	漬物
つけやきば	付け焼き刃
つけやきば	付焼刃
つごう	都合
つじ	辻
つじつま	辻褄
つた	蔦
つたえ	伝え
つたな	拙
つたわ	伝わ
つち	槌
つち	鎚
つち	土
つちおと	槌音
つちか	培
つちくれ	土くれ
つちのえ	戊
つちのと	己
つちふまず	土踏まず
つつ	筒
つつ	包
つづ	続
つづ	綴
つつうらうら	津々浦々
つっかえ	突っ返
つっかか	突っかか
つづけ	続け
つっけんどん	突慳貪
つっこ	突っ込
つつし	謹
つつし	慎
つつしんで	謹んで
つっつ	突っつ
つっぱ	突っ張
つっぱし	つっ走
つっぷ	つっ伏
つつみ	堤
つつみ	包
つづみ	鼓
つつみがみ	包み紙
つつみこ	包み込
つづり	綴
つて	伝
つて	伝手
つど	集
つど	都度
つとま	勤ま
つとめ	勤め
つとめ	努め
つとめ	勉め
つとめ	務め
つとめさき	勤め先
つとめて	努めて
つな	繋
つな	綱
つなが	繋が
つなぎ	繋
つなぎとめ	つなぎ止め
つなげ	繋げ
つなみ	津波
つね	恒
つね	常
つねづね	常々
つの	角
つの	募
つば	唾
つば	鍔
つばき	椿
つばさ	翼
つばめ	燕
つぶ	潰
つぶ	粒
つぶて	礫
つぶより	粒選り
つぶれ	潰れ
つぼ	坪
つぼ	壷
つぼすう	坪数
つま	詰ま
つま	妻
つま	摘
つまさき	爪先
つまづ	躓
つまみだ	つまみ出
つみ	罪
つみあげ	積み上げ
つみかえ	積み替え
つみかさな	積み重な
つみかさね	積み重ね
つみき	積木
つみこ	積み込
つみだ	積み出
つみたて	積み立て
つみたて	積立て
つみに	積荷
つみのこ	積み残
つみほろぼし	罪滅ぼし
つむ	紡
つむぎ	紬
つめ	詰め
つめ	爪
づめ	詰め
つめあわせ	詰め合わせ
つめあわせ	詰合せ
つめあわせ	詰合わせ
つめかえ	詰め替え
つめかけ	詰めかけ
つめこ	詰め込
つめご	詰碁
つめしょ	詰所
つめしょうぎ	詰将棋
つめた	冷た
つも	積も
つや	艶
つや	通夜
つゆ	梅雨
つゆ	露
つよ	強
つよき	強気
つよま	強ま
つよめ	強め
つら	辛
つら	面
つらがまえ	面構え
つらな	連な
つらぬ	貫
つらぬきとお	貫き通
つらね	連ね
つりあ	釣り合
つりあい	釣合
つりあが	つり上が
つりあげ	つり上げ
つりだ	吊り出
つりだ	釣り出
つる	弦
つる	吊
つる	鶴
つるぎ	剣
つるっぱげ	つるっ禿
つるべ	釣瓶
つれ	連れ
つれかえ	連れ帰
つれこ	連れ込
つれそ	連れ添
つれだ	連れ出
つれもど	連れ戻
つんぼ	聾
て	手
て	照
で	出
であ	出会
てあし	手足
であし	出足
てあつ	手厚
てあて	手当
てあら	手荒
てあらい	手洗い
である	出歩
てい	体
てい	丁
てい	呈
てい	底
てい	挺
てい	訂
てい	邸
ていあつ	低圧
ていあん	提案
ていい	定位
ていいん	定員
ていえん	庭園
ていおう	帝王
ていおん	低温
ていおん	低音
ていか	低下
ていか	低価
ていか	定価
ていかく	定格
ていがく	低額
ていがく	定額
ていがくねん	低学年
ていかん	定款
ていき	定期
ていき	提起
ていぎ	定義
ていきあつ	低気圧
ていぎいき	定義域
ていきゅう	低級
ていきゅう	定休
ていきゅう	庭球
ていきゅうび	定休日
ていきょう	提供
ていきん	提琴
ていくう	低空
ていけい	定型
ていけい	提携
ていけつ	締結
ていけん	定見
ていげん	低減
ていげん	提言
ていこう	抵抗
ていこく	定刻
ていこく	帝国
ていさい	体裁
ていざいは	定在波
ていさつ	偵察
ていし	停止
ていじ	呈示
ていじ	定時
ていじ	提示
ていしきか	定式化
ていじせい	定時制
ていしつ	低湿
ていしゃ	停車
ていしゅ	亭主
ていじゅう	定住
ていしゅかんぱく	亭主関白
ていしゅく	貞淑
ていしゅつ	提出
ていしゅつび	提出日
ていしょう	提唱
ていじょう	呈上
ていじょう	定常
ていしょく	定職
ていしょく	定食
ていしょく	抵触
ていしん	逓信
でいすい	泥酔
ていすいじゅん	低水準
ていすう	定数
ていせい	定性
ていせい	訂正
ていせいてき	定性的
ていせつ	定説
ていせん	停戦
ていそ	提訴
ていそう	貞操
ていそく	低速
ていぞく	低俗
ていたい	停滞
ていたく	邸宅
ていだん	鼎談
ていち	低地
ていち	定置
ていちゃく	定着
ていちょう	丁重
ていちょう	低調
ていっぱい	手一杯
ていてつ	蹄鉄
ていてん	定点
ていでん	停電
ていと	帝都
ていど	程度
ていとう	低頭
ていとう	抵当
ていどさ	程度差
ていねい	丁寧
でいねい	泥濘
ていねん	定年
ていのう	低能
ていはく	停泊
ていはく	碇泊
ていばん	定番
ていひょう	定評
ていへん	底辺
ていぼう	堤防
ていめい	低迷
ていめん	底面
ていらく	低落
ていり	低利
ていり	定理
でいり	出入り
でいりぐち	出入口
ていりつ	低率
ていりゅう	停留
ていりゅう	底流
ていりょう	定量
ていりょうてき	定量的
ていれ	手入れ
ていれい	定例
てうす	手薄
ておくれ	手遅れ
ておち	手落ち
ており	手織
てがかり	手がかり
てがかり	手掛かり
てがき	手書き
てがけ	手がけ
てがけ	手掛け
でかけ	出かけ
てかげん	手加減
てかず	手数
でかせぎ	出稼ぎ
てがた	手形
てがた	手堅
てがみ	手紙
てがら	手柄
てがる	手軽
てき	敵
てき	的
てき	適
でき	出来
できあい	出来合い
できあい	溺愛
できあが	出来上が
てきい	敵意
てきおう	適応
てきがいしん	敵愾心
てきかく	的確
てきかく	適格
てきぎ	適宜
てきごう	適合
できごと	出来事
てきざい	適材
てきし	敵視
てきじ	適時
できし	溺死
てきしゃ	適者
てきしゅつ	摘出
てきしゅつりつ	摘出率
てきじょ	滌除
てきじん	敵陣
てきせい	適性
てきせい	適正
てきせつ	適切
てきたい	敵対
できだか	出来高
てきち	敵地
てきち	適地
てきちゅう	的中
てきど	適度
てきとう	適当
てきにん	適任
できばえ	出来栄え
てきはつ	摘発
てきひ	適否
てきびし	手厳し
てきほう	適法
てきやく	適役
てきよう	摘要
てきよう	適用
てきりょう	適量
てきれい	適齢
てきれいき	適齢期
てぎわ	手際
でく	木偶
てくだ	手管
てぐち	手口
でぐち	出口
てくび	手首
てこ	梃
てごたえ	手応え
でこぼこ	凸凹
てごま	手駒
てごめ	手篭め
てごろ	手ごろ
てごろ	手頃
てごわ	手ごわ
てごわ	手強
てさき	手先
でさき	出先
てさげ	手提
てさげ	手提げ
てざわり	手触り
でし	弟子
てしごと	手仕事
てした	手下
てじな	手品
てじゅん	手順
てじゅんしょ	手順書
てじょう	手錠
てすう	手数
てずから	手ずから
てぜま	手狭
でそろ	出そろ
てだし	手出し
てだすけ	手助け
てだて	手立て
てぢか	手近
てちがい	手違い
てちょう	手帖
てちょう	手帳
てっ	徹
てつ	徹
てつ	鉄
てっかい	撤回
てつがく	哲学
てっかば	鉄火場
てっかん	鉄管
てっき	敵機
てっき	鉄器
てっきょ	撤去
てっきょう	鉄橋
てっきん	鉄筋
でつく	出尽く
てづくり	手作り
てつけきん	手付金
てっこう	鉄工
てっこう	鉄鉱
てっこう	鉄鋼
てつごうし	鉄格子
てっこつ	鉄骨
てつざい	鉄材
てっしゅう	撤収
てっしょう	徹宵
てつじょうもう	鉄条網
てつじん	哲人
てつじん	鉄人
てっせい	鉄製
てっせん	鉄扇
てっせん	鉄線
てっそく	鉄則
てつだ	手伝
てったい	撤退
でっち	丁稚
てつづき	手続
てつづき	手続き
てってい	徹底
てっとう	鉄塔
てつどう	鉄道
てっとうてつび	徹頭徹尾
てっとりばや	手っ取り早
でっぱ	出っぱ
でっぱ	出っ歯
てっぱい	撤廃
てっぱん	鉄板
てつびん	鉄瓶
てっぷ	轍鮒
てっぺい	撤兵
てっぺん	天辺
てつぼう	鉄棒
てっぽう	鉄砲
てづま	手詰ま
てづまり	手詰り
てつや	徹夜
てつり	哲理
でどころ	出どころ
でどころ	出所
てどり	手取り
でなお	出直
てなおし	手直し
てぬき	手抜き
てぬぐい	手ぬぐい
てぬぐい	手拭い
てのひら	手の平
てのひら	掌
でば	出刃
てはい	手配
でばがめ	出歯亀
てはじめ	手始め
てばな	手放
でばぼうちょう	出刃包丁
でばん	出番
てびかえ	手控え
てびき	手引
てびき	手引き
てぶくろ	手袋
でぶしょう	出不精
てふだ	手札
てべんとう	手弁当
てほどき	手ほどき
てほん	手本
てま	手間
てまえ	手前
てまえがって	手前勝手
てまど	手間取
てまり	手毬
でまわ	出回
てまわし	手回し
てみじか	手短
でみせ	出店
でむ	出向
てむか	手向か
でむかえ	出迎え
でめきん	出目金
てもち	手持ち
てもと	手元
てら	寺
てら	照ら
てら	衒
てりかえ	照り返
てりつけ	照りつけ
てる	輝
てる	照
てれ	照れ
てれくさ	照れ臭
てれびきょく	テレビ局
てれんてくだ	手練手管
てわけ	手分け
てわた	手渡
てん	天
てん	転
てん	点
でんあつ	電圧
てんい	転位
てんい	転移
でんい	電位
てんいむほう	天衣無縫
てんいん	店員
でんえん	田園
てんえんせい	展延性
てんか	天下
てんか	添加
てんか	転化
てんか	転嫁
てんか	点火
でんか	殿下
でんか	電化
でんか	電荷
てんかい	展開
てんかい	転回
てんがい	天涯
でんかい	電解
てんかん	転換
てんき	天気
てんき	転機
てんき	転記
でんき	電器
でんき	電機
でんき	電気
でんきゅう	電球
てんきょ	典拠
てんきょ	転居
てんぎょう	転業
でんきょく	電極
てんきん	転勤
てんぐ	天狗
てんくう	天空
てんくぎ	天釘
てんけい	典型
でんげき	電撃
てんけん	点検
でんげん	電源
てんこ	点呼
てんこう	天候
てんこう	転向
てんこう	転校
てんごく	天国
でんごん	伝言
てんさい	天才
てんさい	天災
てんさい	転載
てんざい	点在
てんさく	添削
でんさんき	電算機
てんし	天使
てんじ	展示
てんじ	点字
でんし	電子
でんじ	電磁
でんじき	電磁気
でんじは	電磁波
てんしゃ	転写
でんしゃ	電車
でんしゃちん	電車賃
てんしゅ	店主
てんじゅ	天寿
でんじゅ	伝授
てんしゅつ	転出
てんしゅどう	天主堂
てんしょ	添書
てんしょ	篆書
てんしょう	転生
てんじょう	天井
てんじょう	天上
てんじょう	添乗
でんしょう	伝承
てんじょううら	天井裏
てんじょうてんげ	天上天下
てんしょく	天職
てんしょく	転職
でんしょばと	伝書鳩
てんしん	転身
てんしん	転進
てんしん	点心
てんじん	天神
でんしん	電信
てんしんらんまん	天真爛漫
てんすう	点数
てんせい	天性
てんせい	展性
てんせい	転成
てんせき	転石
てんせき	転籍
でんせつ	伝説
てんせん	点線
でんせん	伝染
でんせん	電線
でんせんびょう	伝染病
てんそう	転送
でんそう	伝送
でんそう	電送
てんそく	天測
てんそく	纏足
てんぞく	転属
てんたい	天体
でんたく	電卓
でんたつ	伝達
てんたん	恬淡
てんち	天地
てんち	転地
てんち	転置
でんち	電池
てんちゅう	天誅
でんちゅう	殿中
でんちゅう	電柱
てんちょう	天頂
てんちょう	店長
てんちょう	転調
てんてき	天敵
てんてき	点滴
でんてつ	電鉄
てんとう	店頭
てんとう	転倒
てんとう	点灯
でんとう	伝統
でんとう	電灯
でんどう	伝導
でんどう	殿堂
でんどう	電動
でんどうき	電動機
てんどうせつ	天動説
てんどん	天丼
てんない	店内
てんにゅう	転入
てんにょ	天女
てんにん	転任
でんねつ	伝熱
でんねつ	電熱
てんねん	天然
てんねんとう	天然痘
てんのう	天皇
てんのうせい	天皇制
でんぱ	電波
てんばい	転売
てんぱん	典範
でんぱん	伝搬
てんぴ	天火
てんぴ	天日
てんびき	天引き
てんびょう	点描
でんぴょう	伝票
てんびん	天秤
てんぷ	添付
でんぶ	田麸
てんぷく	転覆
てんぶくろ	天袋
てんぷら	天麸羅
てんぶん	天分
でんぶん	伝聞
でんぶん	電文
てんぺん	転変
てんぺんちい	天変地異
てんぽ	店舗
てんぼう	展望
でんぽう	電報
てんまく	天幕
てんません	伝馬船
てんまつ	顛末
てんまんぐう	天満宮
てんめつ	点滅
てんもん	天文
てんゆうしんじょ	天祐神助
てんよう	転用
でんらい	伝来
てんらく	転落
てんらん	展覧
てんり	天理
でんりゅう	電流
でんりょく	電力
でんれい	伝令
てんれつ	点列
でんわ	電話
でんわきょく	電話局
でんわだい	電話代
でんわちょう	電話帳
と	解
と	研
と	戸
と	採
と	撮
と	釈
と	取
と	摂
と	説
と	跳
と	賭
と	都
と	盗
と	飛
と	富
と	捕
と	問
と	溶
ど	°
ど	度
どあい	度合
どあほ	ど阿呆
とい	樋
とい	問
といあわせ	問い合わせ
といあわせ	問合せ
といかけ	問いかけ
といき	吐息
といし	砥石
といただ	問い質
といただ	問い正
とう	党
とう	唐
とう	塔
とう	投
とう	棟
とう	灯
とう	当
とう	等
とう	糖
どう	動
どう	同
どう	胴
どう	銅
とうあん	答案
とうい	糖衣
どうい	同位
どうい	同意
どうい	胴衣
とういつ	統一
どういつ	同一
どういつし	同一視
とういん	登院
とういん	党員
とういん	頭韻
どういん	動員
とうえい	投影
どうおん	同音
とうおんせん	等温線
とうか	投下
とうか	灯火
とうか	等価
とうか	透過
どうか	同化
どうか	銅貨
どうが	動画
どうが	童画
とうかい	倒壊
とうかい	韜晦
とうがい	当該
とうかく	倒閣
とうかく	当確
とうかく	頭角
どうかく	同格
どうがく	同額
どうがぞう	動画像
とうかつ	統括
どうかつ	恫喝
とうがらし	唐辛子
とうかん	投函
とうかん	等閑
とうがん	冬瓜
どうかん	同感
どうがん	童顔
とうき	登記
とうき	冬期
とうき	冬季
とうき	投棄
とうき	投機
とうき	当期
とうき	当機
とうき	陶器
とうき	騰貴
とうぎ	討議
どうき	動機
どうき	動悸
どうき	同期
どうぎ	動議
どうぎ	同義
とうきゅう	投球
とうきゅう	等級
とうぎゅう	闘牛
どうきゅう	同級
どうきゅう	撞球
とうぎょ	統御
どうきょ	同居
どうきょう	同郷
どうぎょう	同業
とうきょく	当局
どうきん	同衾
どうぐ	道具
どうくつ	洞窟
とうぐん	東軍
とうげ	峠
どうけ	道化
とうけい	東経
とうけい	統計
とうげい	陶芸
どうけい	同型
どうけい	同形
どうけい	同系
とうけつ	凍結
とうげつ	当月
どうげつ	同月
とうけん	刀剣
どうけん	同県
とうげんきょう	桃源郷
とうご	統語
とうこう	登校
とうこう	投稿
とうこう	投降
とうごう	等号
とうごう	統合
どうこう	動向
どうこう	同好
どうこう	同行
どうこう	瞳孔
とうごうしゃ	統合者
とうこうせん	等高線
どうこうのし	同好の士
どうこうほう	道交法
とうごく	投獄
どうこく	同国
どうこく	慟哭
とうこん	闘魂
どうこん	同根
どうこん	同梱
とうざ	当座
どうさ	動作
とうさい	搭載
とうざい	東西
とうさく	倒錯
とうさく	盗作
とうさつ	盗撮
どうさつ	洞察
とうさま	父様
とうさん	倒産
とうさん	父さん
どうさん	動産
とうし	凍死
とうし	投資
とうし	透視
とうし	闘士
とうし	闘志
とうじ	杜氏
とうじ	冬至
とうじ	湯治
とうじ	当時
とうじ	答辞
どうし	動詞
どうし	同士
どうし	同市
どうし	同志
どうし	同氏
どうじ	同時
どうじ	童子
とうしき	等式
とうじき	陶磁器
どうじく	同軸
とうじしゃ	当事者
とうしつ	等質
とうじつ	当日
どうしつ	同室
どうしつ	同質
どうじつ	同日
とうしゃ	投射
とうしゃ	当社
とうしゃ	透写
どうしゃ	同社
どうしゃく	同尺
とうしゃばん	謄写版
とうしゅ	党首
とうしゅ	投手
とうしゅ	当主
どうしゅ	同種
とうしゅう	踏襲
とうしょ	島嶼
とうしょ	投書
とうしょ	当初
どうじょ	童女
とうしょう	凍傷
とうじょう	登場
とうじょう	搭乗
どうしょう	銅賞
どうじょう	同上
どうじょう	同乗
どうじょう	同情
どうじょう	道場
どうしょういむ	同床異夢
どうしょく	同色
どうしょくぶつ	動植物
とうしん	投身
とうしん	答申
とうじん	蕩尽
どうしん	同心
どうしん	童心
どうじん	同人
どうしんえん	同心円
どうじんし	同人誌
とうしんだい	等身大
とうすい	陶酔
どうすう	同数
とうせい	当世
とうせい	統制
とうせい	陶製
どうせい	動静
どうせい	同姓
どうせい	同性
どうせい	同棲
どうせい	同声
どうせい	銅製
とうせき	投石
とうせき	透析
どうせき	同席
とうせん	当選
とうぜん	当然
どうせん	導線
どうぜん	同然
とうそう	党争
とうそう	逃走
とうそう	闘争
どうそう	同相
どうそう	同窓
どうぞう	銅像
とうぞく	盗賊
とうそつ	統率
とうた	淘汰
とうだい	灯台
とうだい	燈台
とうだい	当代
どうたい	導体
どうたい	胴体
どうたく	銅鐸
とうたつ	到達
どうだん	同断
とうち	倒置
とうち	当地
とうち	統治
どうち	同値
どうち	同地
とうちゃく	到着
とうちゃん	父ちゃん
どうちゅう	道中
とうちょう	登頂
とうちょう	盗聴
どうちょう	同調
どうちょう	道庁
とうちょうよう	頭頂葉
とうちょく	当直
とうつう	疼痛
どうつう	導通
とうてい	到底
どうてい	同定
どうてい	童貞
どうてい	道程
とうてき	投擲
どうてき	動的
とうてん	当店
とうてん	読点
とうでん	盗電
どうてん	動転
どうてん	同点
どうでん	導電
とうと	貴
とうと	尊
とうとう	滔々
どうとう	同等
どうどう	堂々
どうどうめぐり	堂々巡り
どうとく	道徳
とうとつ	唐突
とうどり	頭取
とうない	党内
どうない	道内
どうなが	胴長
とうなん	東南
とうなん	盗難
とうにゅう	投入
どうにゅう	導入
どうにゅうご	導入後
とうにん	当人
とうねん	当年
どうねん	同年
とうは	党派
とうは	踏破
どうは	道破
どうはい	同輩
とうばく	倒幕
とうはつ	頭髪
とうばつ	討伐
とうはん	登攀
とうばん	当番
どうはん	同伴
とうひ	当否
とうひ	逃避
とうひこう	逃避行
とうひょう	投票
とうびょう	投錨
とうびょう	闘病
どうひょう	道標
とうふ	豆腐
とうぶ	東部
とうぶ	当部
とうぶ	頭部
どうふ	豆腐
どうふう	同封
どうぶつ	動物
とうぶん	当分
とうぶん	等分
とうぶん	糖分
とうへき	盗癖
とうべん	答弁
とうへんぼく	唐変木
とうほう	東方
とうほう	当方
とうほう	等方
とうぼう	逃亡
とうほく	東北
とうほん	謄本
とうほんせいそう	東奔西走
どうまごえ	胴間声
どうみゃく	動脈
どうみゃくこうか	動脈硬化
とうみょう	灯明
とうみん	冬眠
とうみん	島民
とうめい	透明
どうめい	同名
どうめい	同盟
とうめん	当面
どうもう	獰猛
とうもく	頭目
どうもく	瞠目
どうもと	胴元
とうもろこし	玉蜀黍
とうやく	投薬
とうゆ	灯油
どうゆう	同友
とうよ	投与
とうよう	登用
とうよう	当用
どうよう	動揺
どうよう	同様
どうよう	童謡
とうらい	到来
とうらく	当落
どうらく	道楽
どうらん	動乱
どうらん	胴乱
どうり	道理
とうりつ	倒立
どうりつ	同率
とうりゅう	逗留
とうりゅうもん	登竜門
とうりょう	投了
とうりょう	等量
とうりょう	頭領
どうりょう	同僚
どうりょく	動力
とうるい	盗塁
どうるい	同類
どうれつ	同列
どうろ	道路
とうろう	灯篭
とうろう	灯籠
とうろく	登録
とうろん	討論
どうわ	同和
どうわ	童話
とうわく	当惑
とえ	十重
とえい	都営
とお	遠
とお	十
とお	通
とおあさ	遠浅
とおか	10日
とおか	１０日
とおか	十日
とおく	遠く
とおざか	遠ざか
とおざけ	遠ざけ
とおし	通し
とおで	遠出
とおの	遠の
とおまき	遠巻き
とおまわし	遠回し
とおまわり	遠回り
とおやま	遠山
とおり	通り
とおりすぎ	通り過ぎ
とおりぬけ	通り抜け
とか	解か
とか	都下
とか	融か
とか	溶か
とが	科
とが	尖
とかい	都会
とかげ	蜥蜴
どかた	土方
とがめ	咎め
とき	時
とき	鴇
とぎ	砥
どき	土器
ときおり	時おり
ときおり	時折
ときどき	時々
どきどき	ドキドキ
ときふせ	説き伏せ
どきょう	度胸
ときょうそう	徒競走
とぎれ	途切れ
とぎん	都銀
とく	得
とく	徳
とく	特
とく	督
どく	毒
とくい	得意
とくい	特異
とくいげ	得意気
どくえん	独演
どくかい	読解
どくがく	独学
とくがわ	徳川
とくぎ	特技
どくご	独語
どくさい	独裁
とくさく	得策
とくさん	特産
とくし	特使
とくし	篤志
どくじ	独自
とくしつ	得失
とくしつ	特質
とくしってん	得失点
どくしゃ	読者
とくしゅ	特殊
とくじゅ	特需
とくしゅう	特集
どくしょ	読書
とくしょう	特賞
どくしょう	独唱
とくしょく	特色
とくしん	得心
とくしん	特進
どくしん	独身
とくせい	特性
とくせい	特製
どくせい	毒性
とくせつ	特設
とくせん	特選
どくせん	独占
どくせんじょう	独擅場
どくそ	毒素
とくそう	特捜
どくそう	独創
どくそう	独奏
どくそう	独走
とくそく	督促
とくだい	特大
どくだん	独断
どくだんじょう	独壇場
とぐち	戸口
とくちゅう	特注
とくちょう	特徴
とくちょう	特長
とくてい	特定
とくてん	得点
とくてん	特典
とくとう	特等
どくとく	独特
どくどくし	毒々し
とくに	特に
とくは	特派
どくは	読破
とくばい	特売
とくはいん	特派員
どくはく	独白
とくひつ	特筆
とくべつ	特別
どくぼう	独房
どくほん	読本
とくめい	匿名
とくめい	特命
とくやく	特約
どくやく	毒薬
とくゆう	特有
とくよう	徳用
どくりつ	独立
どくりょく	独力
とくれい	特例
とくれい	督励
とけ	融け
とけ	熔け
とげ	刺
とげ	遂げ
とけい	時計
どけい	時計
とけつ	吐血
どけん	土建
とこ	床
どこ	何処
とこう	渡航
どごう	土豪
どごう	怒号
とこなつ	常夏
とこばしら	床柱
とこや	床屋
ところ	処
ところ	所
ところどころ	所々
とざ	閉ざ
とさつ	屠殺
とざま	外様
とざん	登山
とし	歳
とし	都市
とし	年
とし	敏
とじ	綴じ
とじ	刀自
とじ	閉じ
としあけ	年明け
としうえ	歳上
としうえ	年上
とじこめ	閉じ込め
としごろ	年頃
としつき	年月
としなみ	年波
としま	年増
とじまり	戸締り
どしゃ	土砂
としゅくうけん	徒手空拳
としょ	図書
とじょう	途上
どじょう	土壌
どじょう	鯲
どじょう	鰌
とじょうこく	途上国
としょかん	図書館
としより	年寄り
としん	都心
どすう	度数
とぜつ	途絶
とそ	屠蘇
とそう	塗装
どそう	土葬
どぞう	土蔵
どそく	土足
どだい	土台
とだえ	途絶え
とだな	戸棚
とたん	塗炭
とたん	途端
どたんば	土壇場
とち	土地
とちゅう	途中
とちょう	都庁
とつ	嫁
とつ	凸
とっか	特化
とっか	特価
とっかい	特解
どっかい	読解
とっかん	突貫
とっき	突起
とっきゅう	特急
とっきょ	特許
どっきんほう	独禁法
とっくみあ	取っ組み合
とっくり	徳利
とっくん	特訓
とつげき	突撃
とっけん	特権
とっこう	特高
とっこうやく	特効薬
とっしゅつ	突出
とつじょ	突如
とつじょとして	突如として
とっしん	突進
とつぜん	突然
とったん	突端
とつにゅう	突入
とっぱ	突破
とっぱつ	突発
とっぱん	凸版
とっぴょうし	突拍子
とっぷう	突風
とつべん	訥弁
どて	土手
とてい	徒弟
とど	届
ととう	徒党
どとう	怒涛
とどうふけん	都道府県
とどけ	届
とどけ	届け
とどけで	届出
とどこお	滞
ととの	整
ととの	調
ととのえ	整え
ととのえ	調え
とどま	留ま
とどまつ	椴
とどめ	止め
とどめ	留め
とどろ	轟
どな	怒鳴
とない	都内
となえ	唱え
どなべ	土鍋
となり	隣
となりあ	隣り合
となりあわせ	隣合わせ
どにち	土日
との	殿
とのがた	殿方
どのよう	どの様
とば	飛ば
とはいえ	とは言え
とばく	賭博
どばと	土鳩
とばり	帳
とひ	都鄙
とび	鳶
とびおり	飛び降り
とびか	飛び交
とびこ	飛び越
とびこ	飛び込
とびこえ	飛び越え
とびだ	飛び出
とびち	飛び散
とびち	飛び地
とびつ	飛びつ
とびの	飛び乗
とびはね	飛び跳ね
とびまわ	飛び回
どひょう	土俵
とびら	扉
どびん	土瓶
とぶくろ	戸袋
とべい	渡米
どべい	土塀
とほ	徒歩
とほう	途方
どぼく	土木
とぼし	乏し
とま	止ま
とま	泊ま
とま	留ま
どま	土間
とまど	戸惑
とまり	泊り
とまりこ	泊り込
とみ	富
とみん	都民
とむら	弔
とめ	止め
とめ	停め
とめ	泊め
とめ	留め
とめそで	留袖
とも	供
とも	共
とも	灯
とも	友
ども	吃
ともえ	巴
ともしび	灯火
ともだち	友達
ともども	共々
ともな	伴
ともばたらき	共働き
ともびき	友引
とよ	豊
どよう	土曜
どよう	土用
どようび	土曜日
とら	虎
とら	寅
とらい	渡来
とらえ	捉え
とらえ	捕え
とらえ	捕らえ
とらどし	寅年
とらわれ	因われ
とらわれ	捕らわれ
とり	鳥
とり	酉
とりあ	取り合
とりあえず	取り敢えず
とりあげ	とり上げ
とりあげ	取り上げ
とりあつか	取り扱
とりあつかい	取扱
とりあつめ	取り集め
とりい	鳥居
とりいそぎ	取り急ぎ
とりいれ	採り入れ
とりいれ	取り入れ
とりいれ	取入れ
とりえ	取り柄
とりおこな	執り行
とりおと	取り落と
とりがー	トリガー
とりかえ	取り換え
とりかえ	取り替え
とりかえ	取り返
とりかか	取り掛か
とりかこ	取り囲
とりかわ	取り交わ
とりきめ	取り決め
とりく	取り組
とりくず	取り崩
とりけ	取り消
とりけし	取消
とりこ	取り込
とりこ	虜
とりこわ	取り壊
とりさ	取り去
とりさげ	取り下げ
とりしき	取り仕切
とりしま	取り締ま
とりしまり	取締り
とりしまりやく	取締役
とりしらべ	取り調べ
とりしらべ	取調
とりそろ	取り揃
とりそろえ	取り揃え
とりだ	取り出
とりたて	取り立て
とりたて	取立
とりちがえ	取り違え
とりつ	取り次
とりつ	取り付
とりつ	都立
とりつくろ	取り繕
とりつけ	取り付け
とりつけ	取付
とりで	砦
とりどし	酉年
とりとめ	取り留め
とりな	執り成
とりのこ	取り残
とりのぞ	取り除
とりはから	取り計ら
とりはず	取り外
とりはだ	鳥肌
とりはら	取り払
とりひき	取り引き
とりひき	取引
とりひきさき	取引先
とりぷる	トリプル
とりま	取り巻
とりまぜ	取り混ぜ
とりまとめ	取りまとめ
とりみだ	取り乱
とりめ	鳥目
とりも	取り持
とりもど	取り戻
とりもの	捕物
とりやめ	取り止め
とりょう	塗料
どりょう	度量
どりょうこう	度量衡
どりょく	努力
とりよせ	取り寄せ
どれい	土鈴
どれい	奴隷
とろ	吐露
とろ	瀞
どろ	泥
とろう	徒労
どろじあい	泥試合
どろどろ	泥々
どろなわ	泥縄
どろぬま	泥沼
とろりーせん	トロリー線
とろろあおい	黄蜀葵
どん	鈍
どんか	鈍化
とんかつ	豚カツ
どんかん	鈍感
どんこう	鈍行
どんじゅう	鈍重
とんちゃく	頓着
どんちょう	緞帳
とんちんかん	頓珍漢
どんつう	鈍痛
どんてん	曇天
とんでんへい	屯田兵
とんび	鳶
どんぶり	丼
とんぼ	蜻蛉
とんぼがえり	とんぼ返り
とんぼがえり	蜻蛉返り
どんま	鈍磨
どんよく	どん欲
どんよく	貪欲
どんらん	貪婪
な	為
な	泣
な	菜
な	成
な	凪
な	薙
な	無
な	名
な	鳴
な	啼
ない	内
ないか	内科
ないかい	内科医
ないがい	内外
ないかく	内角
ないかく	内閣
ないがしろ	蔑ろ
ないきょく	内局
ないきん	内勤
ないこう	内向
ないこく	内国
ないざい	内在
ないし	乃至
ないじ	内示
ないしきょう	内視鏡
ないじつ	内実
ないじゅ	内需
ないしゅっけつ	内出血
ないしょ	内緒
ないじょう	内情
ないしょく	内職
ないしん	内心
ないしん	内申
ないしん	内診
ないしんのう	内親王
ないせい	内省
ないせい	内政
ないせい	内声
ないせき	内積
ないせつ	内接
ないせん	内戦
ないせん	内線
ないそう	内層
ないそう	内挿
ないそう	内装
ないぞう	内臓
ないぞう	内蔵
ないだく	内諾
ないち	内地
ないてい	内定
ないてき	内的
ないねん	内燃
ないはつ	内発
ないぶ	内部
ないふん	内紛
ないほう	内包
ないみつ	内密
ないめん	内面
ないやく	内約
ないゆう	内憂
ないよう	内容
ないらん	内乱
ないりく	内陸
ないりょく	内力
なえ	萎え
なえ	苗
なお	治
なお	尚
なお	直
なお	猶
なか	中
なか	仲
なが	永
なが	長
なが	流
ながあめ	長雨
なかい	仲居
ながい	長居
ながいき	長生き
ながうた	長唄
なかがい	仲買
ながぐつ	長靴
なかごろ	中ごろ
なかし	仲仕
ながしこ	流し込
ながすぎ	長過ぎ
なかすじ	中筋
ながそで	長袖
なかたがい	仲たがい
なかだち	仲立ち
なかだち	媒
ながたらし	長たらし
なかだるみ	中だるみ
ながちょうば	長丁場
なかつぎ	中継ぎ
ながつき	長月
ながったらし	長ったらし
ながつづき	長続き
なかなおり	仲直り
ながなが	長々
なかには	中には
なかにも	中にも
なかにわ	中庭
なかね	中値
ながねん	永年
ながねん	長年
ながの	永の
なかば	半ば
ながばなし	長話
ながばり	長針
ながび	長引
なかほど	中程
なかま	中間
なかま	仲間
なかみ	中身
ながめ	眺め
ながもち	長持ち
ながや	長屋
なかゆび	中指
なかよ	仲良
なかよし	仲良し
ながらく	長らく
ながれ	流れ
ながれこ	流れ込
ながれだ	流れ出
なき	亡き
なぎ	凪
なぎ	薙
なぎさ	渚
なく	亡く
なく	無く
なぐ	殴
なぐさ	慰
なぐさめ	慰め
なくな	亡くな
なくな	無くな
なげ	嘆
なげ	投げ
なげいれ	投げ入れ
なげかけ	投げかけ
なげかわし	嘆かわし
なげこ	投げ込
なげだ	投げ出
なげつけ	投げつけ
なげやり	投げやり
なご	和
なこうど	仲人
なごやか	和やか
なごり	名残
なごりおし	名残惜し
なさけ	情け
なさけな	情けな
なさけな	情な
なさけぶか	情け深
なざし	名指し
なさそう	無さそう
なし	無し
なし	梨
なじ	詰
なじ	馴染
なしとげ	成し遂げ
なす	擦
なすりつけ	擦り付け
なぜ	何故
なぜか	何故か
なぞ	謎
なぞらえ	準え
なだ	灘
なだか	名高
なだめ	宥め
なだれ	雪崩
なつ	夏
なついん	捺印
なつかし	懐かし
なつかしの	懐かしの
なづけ	名付け
なっとう	納豆
なっとく	納得
なつば	夏場
なっぱ	菜っ葉
なつふく	夏服
なつむき	夏向き
なつめ	棗
なつもの	夏物
なつやすみ	夏休み
なつやま	夏山
なで	撫で
なとり	名取
なな	七
ななそじ	七十路
ななつ	七つ
ななめ	斜め
なに	何
なにがし	某
なにげな	何気な
なにごと	何事
なにしろ	何しろ
なにせ	何せ
なにとぞ	何卒
なにぶん	何分
なにもの	何者
なにゆえ	何故
なにゆえに	何故に
なの	名乗
なのか	7日
なのか	７日
なのか	七日
なぶ	嬲
なぶ	嫐
なふだ	名札
なべ	鍋
なべぞこ	鍋底
なべもの	鍋物
なへん	那辺
なま	生
なま	鈍
なまいき	生意気
なまえ	名前
なまぐさ	生臭
なまくび	生首
なまけ	怠け
なます	膾
なまず	鯰
なまなまし	生々し
なまびょうほう	生兵法
なまみ	生身
なまり	鉛
なまろく	生録
なみ	波
なみ	並
なみ	浪
なみあし	並足
なみかぜ	波風
なみき	並木
なみせん	波線
なみだ	波立
なみだ	涙
なみだぐ	涙ぐ
なみだぐまし	涙ぐまし
なみなみ	並々
なみはずれ	並外れ
なみま	波間
なむ	南無
なめ	嘗め
なめ	鞣
なめらか	滑らか
なや	悩
なやま	悩ま
なやまし	悩まし
なら	慣ら
なら	均
なら	習
なら	楢
なら	並
なら	鳴ら
なら	列
ならいごと	習い事
ならびた	並び立
ならべ	並べ
ならわ	慣わ
ならわ	習わ
なりきん	成金
なりた	成り立
なりたち	成立ち
なりひび	鳴り響
なりゆ	成り行
なりゆき	成行き
なりわい	生業
なれ	慣れ
なれ	熟れ
なれ	馴れ
なれ	狎れ
なれずし	熟鮨
なわ	縄
なわて	畷
なわばり	縄張
なわばり	縄張り
なん	何
なん	難
なんい	南緯
なんい	難易
なんか	南下
なんか	軟化
なんかい	何回
なんかい	南海
なんかい	難解
なんかん	難関
なんぎ	難儀
なんぎょう	難行
なんきょく	難局
なんきん	軟禁
なんぐん	南軍
なんこう	軟膏
なんこう	難航
なんこうふらく	難攻不落
なんごく	南国
なんこつ	軟骨
なんじ	何時
なんじ	爾
なんじ	難事
なんじ	汝
なんしき	軟式
なんしつ	軟質
なんじゃく	軟弱
なんじゅう	難渋
なんしょ	難所
なんしょく	難色
なんすい	軟水
なんせ	何せ
なんせい	南西
なんせい	軟性
なんぞ	何ぞ
なんぞや	何ぞや
なんだい	何台
なんだい	難題
なんたん	南端
なんちゃくりく	軟着陸
なんちょう	難聴
なんてつ	軟鉄
なんでもかんでも	何でもかんでも
なんてん	難点
なんど	何度
なんど	納戸
なんとう	南東
なんとか	何とか
なんなく	難なく
なんにち	何日
なんにょ	男女
なんにん	何人
なんねん	何年
なんぱ	軟派
なんぱ	難破
なんばん	南蛮
なんぴと	何人
なんびょう	何秒
なんびょう	難病
なんぴょうよう	南氷洋
なんぶ	南部
なんぷん	何分
なんぽう	南方
なんぼく	南北
なんみん	難民
なんもん	難問
なんら	何ら
なんら	何等
に	荷
に	似
に	煮
に	二
に	弐
にあ	似合
にあげ	荷揚げ
にいさん	兄さん
にいづま	新妻
にうけ	荷受け
にえ	煮え
にお	臭
にお	匂
におう	仁王
におやか	匂やか
におわ	匂わ
にが	苦
にが	逃
にが	逃が
にかい	二階
にがおえ	似顔絵
にがて	苦手
にがにがし	苦々し
にかよ	似通
にかわ	膠
にがわらい	苦笑い
にぎ	握
にぎやか	賑やか
にぎりつぶ	握りつぶ
にぎわ	賑わ
にく	憎
にく	難
にく	肉
にくかい	肉塊
にくがん	肉眼
にくきゅう	肉球
にくぎゅう	肉牛
にくしみ	憎しみ
にくしょく	肉食
にくしん	肉親
にくせい	肉声
にくたい	肉体
にくづき	肉付き
にくはく	肉薄
にくらし	憎らし
にぐるま	荷車
にげ	逃げ
にげこ	逃げ込
にげだ	逃げ出
にげみち	逃げ道
にげん	二元
にこ	煮込
にご	濁
にごら	濁ら
にころが	煮ころが
にさんかたんそ	二酸化炭素
にし	西
にし	螺
にじ	二次
にじ	虹
にじ	滲
にしかいがん	西海岸
にしかぜ	西風
にしがわ	西側
にしき	錦
にしきごい	錦鯉
にしぐち	西口
にしび	西日
にしび	西陽
にしめ	煮しめ
にしゃたくいつ	二者択一
にじゅう	二十
にじゅう	二重
にじゅう	廿
にじょう	二乗
にしん	二審
にしん	鰊
にせ	贋
にせ	偽
にせ	似せ
にせい	二世
にせもの	偽物
にそくさんもん	二束三文
にたて	煮立て
にち	日
にちげん	日限
にちじ	日時
にちじ	日次
にちじょう	日常
にちどく	日独
にちぶ	日舞
にちぼつ	日没
にちや	日夜
にちよう	日曜
にちようび	日曜日
にちようひん	日用品
につ	似つ
にっか	日課
につかわし	似つかわし
にっかん	日刊
にっかん	日韓
にっき	日記
にっきゅう	日給
にっきん	日勤
にづくり	荷作り
にづくり	荷造り
につけ	煮つけ
にっけい	日系
にっけい	日計
にっこう	日光
にっころが	煮っころが
にっさん	日参
にっさん	日産
にっし	日誌
にっしゃ	日射
にっしょう	日照
にっしょく	日食
にっしんげっぽ	日進月歩
にっすう	日数
にっちゅう	日中
にっちょく	日直
にってい	日程
にっとう	日当
にっぽう	日報
につま	煮詰ま
にど	二度
にどでま	二度手間
にな	担
ににんしょう	二人称
にぬし	荷主
にのうで	二の腕
にのく	二の句
にびいろ	鈍色
にぶ	鈍
にふだ	荷札
にぶん	二分
にぼし	煮干
にほん	二本
にほんいち	日本一
にほんごか	日本語化
にほんしゅ	日本酒
にほんじん	日本人
にほんとう	日本刀
にほんばれ	日本晴れ
にまいごし	二枚腰
にまいじた	二枚舌
にまめ	煮豆
にもつ	荷物
にもの	煮物
にや	煮や
にゅういん	入院
にゅうえき	乳液
にゅうえん	入園
にゅうか	乳化
にゅうか	入荷
にゅうかい	入会
にゅうかいきん	入会金
にゅうかく	入閣
にゅうがく	入学
にゅうがくきん	入学金
にゅうがくしき	入学式
にゅうきょ	入居
にゅうきょう	入鋏
にゅうぎょう	乳業
にゅうきん	入金
にゅうこ	入庫
にゅうこう	入構
にゅうこう	入港
にゅうこく	入国
にゅうこん	入魂
にゅうさつ	入札
にゅうさん	乳酸
にゅうし	乳歯
にゅうし	入試
にゅうじ	乳児
にゅうしつ	入室
にゅうしゃ	入社
にゅうしゅ	入手
にゅうしょ	入所
にゅうしょう	入賞
にゅうじょう	入場
にゅうせいひん	乳製品
にゅうせき	入籍
にゅうせん	入選
にゅうたい	入隊
にゅうだん	入団
にゅうてい	入廷
にゅうでん	入電
にゅうとう	入党
にゅうねん	入念
にゅうばい	入梅
にゅうぶ	入部
にゅうもん	入門
にゅうよう	入用
にゅうようじ	乳幼児
にゅうよく	入浴
にゅうりょう	入寮
にゅうりょく	入力
にゅうわ	柔和
にょい	如意
にょう	尿
にょうぼう	女房
にょらい	如来
にら	韮
にら	睨
にらみあわせ	にらみ合わせ
にりゅう	二流
にりん	二輪
にわ	庭
にわか	俄
にわかあめ	にわか雨
にわき	庭木
にわさき	庭先
にわとり	鶏
にん	人
にん	任
にんい	任意
にんか	認可
にんかん	任官
にんき	人気
にんき	任期
にんきょう	仁侠
にんきょう	任侠
にんぎょう	人形
にんげん	人間
にんげんせい	人間性
にんげんみ	人間味
にんさんぷ	妊産婦
にんしき	認識
にんじゃ	忍者
にんじゅう	忍従
にんしょう	人称
にんしょう	認証
にんじょう	人情
にんじょう	刃傷
にんしん	妊娠
にんじん	人参
にんずう	人数
にんそう	人相
にんそく	人足
にんたい	忍耐
にんち	任地
にんち	認知
にんてい	認定
にんぴ	認否
にんぷ	人夫
にんぷ	妊婦
にんぽう	忍法
にんむ	任務
にんめい	任命
にんめん	任免
ぬ	脱
ぬ	塗
ぬ	抜
ぬ	縫
ぬいこ	縫い込
ぬいつけ	縫いつけ
ぬいめ	縫目
ぬいもの	縫物
ぬえ	鵺
ぬか	糠
ぬか	抜か
ぬき	貫
ぬきさし	抜き差し
ぬきだ	抜き出
ぬきと	抜き取
ぬきんで	抜きん出
ぬく	温
ぬぐ	拭
ぬくも	温も
ぬけ	抜け
ぬけだ	抜け出
ぬけめ	抜目
ぬし	主
ぬす	盗
ぬすびと	盗人
ぬすみ	盗み
ぬすみだ	盗み出
ぬの	布
ぬのきれ	布切れ
ぬのじ	布地
ぬま	沼
ぬまた	沼田
ぬまち	沼地
ぬら	濡ら
ぬり	塗
ぬりつけ	塗り付け
ぬりつぶ	塗りつぶ
ぬる	温
ぬるまゆ	ぬるま湯
ぬれ	濡れ
ね	音
ね	根
ね	寝
ね	値
ね	練
ねあがり	値上がり
ねあげ	値上げ
ねい	寝入
ねいき	寝息
ねいしん	佞臣
ねいろ	音色
ねうち	値打ち
ねえ	姉
ねえさん	姉さん
ねか	寝か
ねがい	願
ねがいさげ	願い下げ
ねぎ	値切
ねぎ	葱
ねぎら	労
ねこ	寝込
ねこ	猫
ねごこち	寝心地
ねこじた	猫舌
ねこぜ	猫背
ねごと	寝言
ねざ	根ざ
ねさがり	値下がり
ねさげ	値下げ
ねざめ	寝覚め
ねじ	捻
ねじ	螺
ねじ	捩
ねじれ	捻れ
ねじれ	捩れ
ねすご	寝過ご
ねずみ	鼠
ねずみこう	鼠講
ねた	妬
ねたばこ	寝煙草
ねだん	値段
ねちがえ	寝違え
ねっ	熱
ねつ	寝つ
ねつ	熱
ねづ	根付
ねつい	熱意
ねつえん	熱演
ねっき	熱気
ねっきょう	熱狂
ねっこ	根っ子
ねっしゃびょう	熱射病
ねっしょう	熱唱
ねっしん	熱心
ねっせん	熱戦
ねつぞう	捏造
ねったい	熱帯
ねったいうりん	熱帯雨林
ねっちゅう	熱中
ねっと	ネット
ねっとう	熱湯
ねっぱ	熱波
ねっぷう	熱風
ねつべん	熱弁
ねつぼう	熱望
ねづよ	根強
ねつりょう	熱量
ねつれつ	熱烈
ねどこ	寝床
ねどし	子年
ねば	粘
ねはば	値幅
ねばりづよ	粘り強
ねはん	涅槃
ねびえ	寝冷え
ねびき	値引き
ねぶか	根深
ねぶそく	寝不足
ねふだ	値札
ねぶみ	値踏み
ねまき	寝間着
ねまわし	根回し
ねみみにみず	寝耳に水
ねむ	眠
ねむけ	眠気
ねむた	眠た
ねむら	眠ら
ねもと	根本
ねら	狙
ねり	練り
ねりあげ	練り上げ
ねりあわせ	練り合わせ
ねりなお	練り直
ねん	年
ねん	念
ねんいり	念入り
ねんが	年賀
ねんがく	年額
ねんがじょう	年賀状
ねんがっぴ	年月日
ねんかん	年刊
ねんかん	年間
ねんがん	念願
ねんき	年忌
ねんき	年期
ねんき	年季
ねんきゅう	年休
ねんきん	年金
ねんぐ	年貢
ねんげつ	年月
ねんこう	年功
ねんごう	年号
ねんごろ	懇ろ
ねんざ	捻挫
ねんさん	年産
ねんし	年始
ねんし	撚糸
ねんじ	年次
ねんしゅう	年収
ねんじゅう	年中
ねんしゅつ	捻出
ねんしょ	念書
ねんしょう	年商
ねんしょう	年少
ねんしょう	燃焼
ねんすう	年数
ねんだい	年代
ねんだんせい	粘弾性
ねんちゃく	粘着
ねんちょう	年長
ねんてん	捻転
ねんど	年度
ねんど	粘土
ねんとう	年頭
ねんとう	念頭
ねんどまつ	年度末
ねんない	年内
ねんねん	年々
ねんぱい	年輩
ねんぱい	年配
ねんぴ	燃費
ねんぴょう	年表
ねんぶつ	念仏
ねんべつ	年別
ねんぽう	年俸
ねんぽう	年報
ねんまく	粘膜
ねんまつ	年末
ねんらい	年来
ねんり	年利
ねんりき	念力
ねんりょう	燃料
ねんりん	年輪
ねんれい	年齢
の	飲
の	載
の	乗
の	退
の	呑
の	野
のう	能
のう	脳
のういっけつ	脳溢血
のうえん	農園
のうか	農家
のうかい	納会
のうがく	能楽
のうがく	農学
のうがくぶ	農学部
のうかすいたい	脳下垂体
のうかん	納棺
のうかんき	農閑期
のうき	納期
のうきぐ	農機具
のうきょう	農協
のうぎょう	農業
のうきん	納金
のうぐ	農具
のうこう	濃厚
のうこう	農耕
のうこうそく	脳硬塞
のうこつ	納骨
のうさぎ	野兎
のうさぎょう	農作業
のうさつ	悩殺
のうさん	農産
のうし	脳死
のうしゃ	納車
のうしゅく	濃縮
のうじょう	農場
のうずい	脳髄
のうぜい	納税
のうそっちゅう	脳卒中
のうそん	農村
のうたん	濃淡
のうち	農地
のうてんき	能天気
のうてんき	脳天気
のうど	濃度
のうどう	能動
のうにゅう	納入
のうは	脳波
のうはんき	農繁期
のうひん	納品
のうふ	納付
のうふ	農夫
のうべん	能弁
のうまく	脳膜
のうみつ	濃密
のうみん	農民
のうむ	濃霧
のうめん	能面
のうやく	農薬
のうり	脳裏
のうりつ	能率
のうりょう	納涼
のうりょく	能力
のうりん	農林
のが	逃
のがれ	逃れ
のき	軒
のぎ	禾
のきさき	軒先
のきなみ	軒並
のけ	除け
のけ	退け
のこ	残
のこぎり	鋸
のこらず	残らず
のこり	残り
のじゅく	野宿
のせ	載せ
のせ	乗せ
のぞ	除
のぞ	覗
のぞ	望
のぞ	臨
のぞきこ	のぞき込
のぞまし	望まし
のぞみ	望み
のたま	宣
のち	後
のちのち	後々
のっか	乗っか
のっけ	乗っけ
のっと	乗っ取
のっと	則
のてん	野天
のてんぶろ	野天風呂
のど	咽
のど	喉
のどか	長閑
のなか	野中
ののし	罵
のば	延ば
のば	伸ば
のばなし	野放し
のはら	野原
のび	延び
のび	伸び
のびなや	伸び悩
のびのび	伸び伸び
のびやか	伸びやか
のぶし	野武士
のべ	延べ
のべ	述べ
のべ	伸べ
のべ	野辺
のぼ	昇
のぼ	上
のぼ	登
のほうず	野放図
のぼりつめ	上り詰め
のみ	蚤
のみかい	飲み会
のみほ	飲み干
のみもの	飲物
のみや	飲み屋
のめりこ	のめり込
のやま	野山
のら	野良
のり	海苔
のり	糊
のりあげ	乗り上げ
のりいれ	乗り入れ
のりうつ	乗り移
のりおくれ	乗り遅れ
のりおり	乗り降り
のりかえ	乗り換え
のりかえ	乗り替え
のりかえ	乗換
のりかえ	乗換え
のりかえ	乗替
のりかえ	乗替え
のりかか	乗りかか
のりかか	乗り掛かる
のりかか	乗り掛る
のりき	乗り切
のりく	乗り組
のりくみいん	乗組員
のりこ	乗り越
のりこ	乗り込
のりこえ	乗り越え
のりすて	乗り捨て
のりだ	乗り出
のりつ	乗り継
のりつけ	乗り付け
のりづけ	糊付け
のりと	祝詞
のりば	乗り場
のりば	乗場
のりまわ	乗り回
のりもの	乗り物
のりもの	乗物
のろ	呪
のろ	鈍
のろし	狼煙
のろわし	呪わし
のんき	暢気
は	喰
は	歯
は	刃
は	掃
は	張
は	貼
は	吐
は	派
は	這
は	矧
は	剥
は	噴
は	葉
は	履
ば	場
ば	張
ば	貼
ばあい	場合
はあく	把握
ばあさん	婆さん
はい	灰
はい	入
はい	廃
はい	拝
はい	排
はい	肺
はい	配
ばい	倍
はいあん	廃案
はいい	配位
はいいろ	灰色
はいいん	敗因
はいいん	配員
ばいう	梅雨
はいえい	背泳
はいえん	肺炎
はいか	排架
はいか	輩下
はいか	配下
はいか	配架
ばいか	倍加
ばいか	売価
はいかい	俳諧
はいかい	徘徊
ばいかい	媒介
ばいがく	倍額
はいかん	廃刊
はいかん	拝観
はいかん	配管
はいがん	肺癌
はいき	廃棄
はいき	排気
ばいきゃく	売却
はいきゅう	廃休
はいきゅう	配給
はいきょ	廃虚
はいぎょう	廃業
はいきん	背筋
ばいきん	黴菌
はいく	俳句
はいぐう	配遇
はいぐうしゃ	配偶者
はいけい	拝啓
はいけい	背景
はいけん	拝見
はいご	背後
はいこう	廃校
はいこう	廃鉱
はいごう	交配
はいごう	配合
はいごれい	背後霊
はいざら	灰皿
はいし	廃止
はいしゃ	歯医者
はいしゃ	廃車
はいしゃ	敗者
はいしゃ	配車
はいしゃく	拝借
ばいしゃく	媒酌
ばいしゅう	買収
はいしゅつ	排出
ばいしゅん	買春
ばいしゅん	売春
はいじょ	排除
ばいしょう	賠償
はいしょく	配色
ばいしょく	陪食
はいしん	背信
はいじん	俳人
はいじん	廃人
ばいしん	陪審
ばいじん	煤塵
はいず	這いず
はいすい	排水
はいすい	配水
はいすいのじん	背水の陣
ばいすう	倍数
はいせき	排斥
はいぜつ	廃絶
はいせん	敗戦
はいせん	配線
はいぜん	配膳
ばいせん	焙煎
はいそ	敗訴
はいそう	配送
ばいぞう	倍増
はいぞく	配属
はいた	排他
はいたい	敗退
ばいたい	媒体
はいたつ	配達
はいち	配置
はいちょう	拝聴
はいでん	配電
ばいてん	売店
はいでんばん	配電盤
はいとう	配当
はいにん	背任
はいのう	背嚢
ばいばい	売買
はいはん	排反
はいはん	背反
はいばん	廃盤
はいび	配備
はいひん	廃品
はいふ	配付
はいふ	配布
はいふく	拝復
はいぶつ	廃物
はいぶつきしゃく	廃仏棄釈
はいぶつきしゃく	排仏毀釈
はいぶん	配分
はいぼく	敗北
ばいめい	売名
はいめん	背面
はいやく	配役
ばいやく	売約
はいゆう	俳優
ばいよう	培養
はいりこ	入り込
ばいりつ	倍率
はいりほう	背理法
はいりょ	配慮
はいれつ	排列
はいれつ	配列
はえ	映え
はえ	栄え
はえ	生え
はえ	這え
はえ	蝿
はおり	羽織
はか	計
はか	諮
はか	図
はか	測
はか	破瓜
はか	墓
はか	謀
はか	量
はが	剥
ばか	化か
ばか	馬鹿
はかい	破壊
はかい	破戒
はがき	葉書
ばかず	場数
はかせ	博士
はかど	捗
はかな	儚
はがね	鋼
はかば	墓場
ばかばかし	バカバカし
はかま	袴
はかまいり	墓参り
はから	計ら
はかり	秤
はかりごと	謀
はがん	破顔
はがんいっしょう	破顔一笑
はき	覇気
はき	破棄
はぎ	矧
はぎ	萩
はぎしり	歯軋り
はきだ	吐き出
はきもの	履物
ばきゃく	馬脚
はきゅう	波及
はぎょう	覇業
はきょく	破局
はぎれ	歯切れ
はぎれ	端切れ
はく	博
はく	泊
はく	箔
ばく	漠
ばく	縛
はくあ	白亜
はくあい	博愛
はくい	白衣
はくがい	迫害
はくがく	博学
はぐく	育
ばくげき	爆撃
はくげきほう	迫撃砲
はくさい	白菜
ばくさい	博才
はくし	博士
はくし	白紙
はくじ	白磁
はくしき	博識
はくじつ	白日
はくしゃ	拍車
はくしゃ	薄謝
はくしゃく	伯爵
はくじゃく	薄弱
はくしゅ	拍手
はくじゅ	白寿
ばくしゅく	爆縮
はくしょ	白書
はくじょう	白状
はくじょう	薄情
ばくしょう	爆笑
はくしょく	白色
はくしん	迫真
はくじん	白人
ばくしん	驀進
はくせい	剥製
はくせき	白皙
ばくぜん	漠然
ばくだい	莫大
はくだく	白濁
はくだつ	剥奪
ばくだん	爆弾
はくち	白痴
ばくち	博打
ばくち	博奕
はくちゅう	白昼
はくちょう	白鳥
はくどう	白銅
はくねつ	白熱
ばくは	爆破
はくばい	白梅
ばくはつ	爆発
はくび	白眉
ばくふ	幕府
ばくふ	瀑布
はくぶつ	博物
はくぶつかん	博物館
はくぶつし	博物誌
はくぼく	白墨
はくまい	白米
ばくまつ	幕末
ばくやく	爆薬
はくらい	舶来
はくらく	伯楽
はくらく	剥落
はくらんかい	博覧会
はくらんきょうき	博覧強記
はくり	剥離
はくり	薄利
はくりょく	迫力
はぐるま	歯車
はくろ	白露
ばくろ	暴露
はくろん	博論
はけ	刷毛
はけ	捌け
はげ	禿
はげ	禿げ
はげ	矧げ
はげ	剥げ
はげ	励
ばけ	化け
はけい	波形
ばけがく	化学
はげし	激し
はげし	烈し
はげま	励ま
はけん	覇権
はけん	派遣
ばけん	馬券
はこ	運
はこ	函
はこ	箱
はごいた	羽子板
はこびこ	運び込
はこびだ	運び出
はこぶね	箱船
はこぶね	方舟
はこぶね	方船
はさ	挟
はさい	破砕
はざかいき	端境期
はさま	挟ま
はざま	間
はざま	狭間
はざま	硲
はさみ	鋏
はさみこ	挟み込
はさん	破産
はし	橋
はし	走
はし	端
はし	箸
はじ	端
はじ	弾
はじ	恥
はじ	恥じ
はじい	恥じ入
はしご	梯子
はしづめ	橋詰
はじま	始ま
はじめ	一
はじめ	始め
はじめ	初め
はじめて	初めて
はしゃ	覇者
ばしゃ	馬車
はしゅつ	派出
はしゅつじょ	派出所
ばしょ	場所
はじょう	波状
はしら	柱
はしりがき	走り書き
はしりこ	走り込
はしりだ	走り出
はしりぬけ	走り抜け
はしりまわ	走り回
はしわたし	橋渡し
はす	蓮
はず	外
はず	弾
はず	筈
はすい	破水
はすう	端数
ばすえ	場末
はずかし	恥ずかし
はずかしめ	辱め
ばすてい	バス停
はずれ	外れ
はせ	馳せ
はぜ	黄櫨
はぜ	櫨
はぜ	鯊
はせい	派生
ばせい	罵声
はせん	波線
はせん	破線
はそん	破損
はた	果た
はた	旗
はた	機
はた	端
はた	畑
はた	畠
はだ	肌
はだ	膚
はだあい	肌合
はたいろ	旗色
はだいろ	肌色
はたえ	二十重
はたおり	機織り
はだか	裸
はだぎ	肌着
はたけ	畑
はたけ	畠
ばたけ	畑
はだざむ	肌寒
はだざわり	肌触り
はだし	裸足
はたして	果して
はたち	二十歳
はたはた	鰰
はだみ	肌身
はたら	働
はたらきかけ	働きかけ
はたん	破綻
はだん	破談
はち	鉢
はち	蜂
ばち	鉢
ばち	罰
はちうえ	鉢植え
ばちがい	場違い
はちく	破竹
はちぶ	八分
はちまき	鉢巻
はちまき	鉢巻き
はちまん	八幡
はちみつ	蜂蜜
はちめんたい	八面体
はちめんろっぴ	八面六臂
はちょう	波長
はっ	発
はつ	初
はつ	発
ばっ	罰
ばつ	罰
ばつ	閥
ばつ	跋
はついく	発育
はつえんとう	発煙筒
はつおん	発音
はつおん	撥音
はっか	薄荷
はっか	発火
はつか	二十日
はつが	発芽
はっかく	発覚
はっかん	発刊
はつがん	発ガン
はっき	発揮
はづき	葉月
はっきゅう	白球
はっきゅう	薄給
はっきゅう	発給
はっきょう	発狂
はっきん	白金
ばっきん	罰金
はっくつ	発掘
ばっくぷろぱげーしょんほう	バックプロパゲーション法
ばつぐん	抜群
はっけっきゅう	白血球
はっけん	発券
はっけん	発見
はつげん	発現
はつげん	発言
ばっこ	跋扈
はつこい	初恋
はっこう	発効
はっこう	発行
はっこう	醗酵
はっこうしゃ	発行者
はっこつ	白骨
はっさん	発散
はっし	発止
はっしゃ	発射
はっしゃ	発車
はっしょう	八章
はっしょう	発祥
はつじょう	発情
はっしん	発信
はっしん	発振
はっしん	発疹
はっしん	発進
はっしんしゃ	発信者
ばっすい	抜粋
はっせい	発生
はっせい	発声
はっそう	発想
はっそう	発送
ばっそく	罰則
はったつ	発達
ばっち	バッチ
はっちゃく	発着
はっちゅう	発注
ばってき	抜擢
はってん	発展
はつでん	発電
はつでんき	発電機
はっと	法度
はつどう	発動
はつに	初荷
はつねつ	発熱
はっぱ	葉っぱ
はつばい	発売
はつびょう	発病
はっぴょう	発表
はっぴょうかい	発表会
はっぴょうしゃ	発表者
はっぷ	発布
はっぷん	発奮
ばつぶん	跋文
はっぽう	八方
はっぽう	発砲
ばっぽん	抜本
はつみみ	初耳
はつめい	発明
はつもうで	初詣
はつゆき	初雪
はつれい	発令
はつろ	発露
はて	果て
はで	派手
はてんこう	破天荒
はと	鳩
はとう	波涛
はどう	波動
ばとう	罵倒
はとどけい	鳩時計
はどめ	歯止め
はな	花
はな	華
はな	鼻
はな	放
はな	離
はな	話
はないた	花板
はなくそ	鼻糞
はなげ	鼻毛
はなざかり	花盛り
はなさき	鼻先
はなし	噺
はなし	話
ばなし	話
はなしあ	話し合
はなしあい	話合い
はなしか	噺家
はなしこ	話し込
はなぞの	花園
はなたかだか	鼻高々
はなたば	花束
はなぢ	鼻血
はなどけい	花時計
はなはだ	甚だ
はなはだし	甚だし
はなばなし	華々し
はなび	花火
はなびえ	花冷え
はなびら	花びら
はなふだ	花札
はなみ	花見
はなみず	鼻水
はなみずき	花水木
はなみち	花道
はなむこ	花婿
はなや	花屋
はなや	華や
はなやか	華やか
はなれ	放れ
はなれ	離れ
はに	埴
はにわ	埴輪
ばぬし	馬主
はね	羽
はね	羽根
はね	跳ね
はねかえ	跳ね返
はは	母
はば	巾
はば	阻
はば	幅
ばば	婆
ばば	馬場
ははおや	母親
はばか	憚
はばた	羽ばた
はばつ	派閥
はばひろ	幅広
ばひつ	馬匹
はふ	葬
はぶ	省
はぶらし	歯ブラシ
はぶり	羽振り
はべ	侍
はへい	派兵
はべらか	侍らか
はへん	破片
はま	浜
はまき	葉巻
はまぐり	蛤
はまや	破魔矢
はみがき	歯磨き
はみがきこ	歯磨き粉
はみで	はみ出
はめ	羽目
はめ	填め
はめこ	はめ込
はめつ	破滅
はめん	波面
ばめん	場面
はも	鱧
はもの	刃物
はもん	波紋
はもん	破門
はや	逸
はや	生や
はや	早
はや	速
はや	流行
はやうま	早馬
はやおき	早起き
はやがてん	早合点
はやく	端役
はやくち	早口
はやし	林
はやし	囃子
はやせ	早瀬
はやて	疾風
はやと	隼人
はやとちり	早とちり
はやばや	早々
はやぶさ	隼
はやべん	早弁
はやま	早ま
はやま	速ま
はやめ	早め
はやめ	速め
はよう	早う
はら	原
はら	晴ら
はら	腹
はら	払
はら	孕
ばら	薔薇
はらいこ	払い込
はらいさげ	払い下げ
はらいもど	払い戻
はらいもどし	払い戻し
はらぐろ	腹黒
はらわた	腸
はらん	波乱
はらんばんじょう	波瀾万丈
はり	針
はり	梁
はり	玻璃
ばり	罵詈
はりあ	張り合
はりあ	張合
はりあわせ	張り合わせ
はりがね	針金
はりがみ	張り紙
はりがみ	貼紙
はりき	張り切
ばりき	馬力
はりこ	張り込
はりこ	張子
はりだ	張り出
はりつけ	張り付け
はる	春
はるか	遥か
はるめ	春め
はるやすみ	春休み
はれ	腫れ
はれ	晴
はれ	晴れ
はれあが	晴れ上が
ばれいしょ	馬鈴薯
はれぎ	晴れ着
はれすがた	晴れ姿
はれつ	破裂
はれわた	晴れ渡
はろう	波浪
はん	判
はん	半
はん	反
はん	版
はん	班
はん	藩
はん	範
ばん	判
ばん	板
ばん	版
ばん	晩
ばん	番
ばん	盤
はんい	範囲
はんえい	反映
はんえい	繁栄
はんえん	半円
はんか	汎化
はんか	繁華
はんか	頒価
ばんか	挽歌
ばんか	晩夏
はんかい	半壊
ばんかい	挽回
ばんがい	番外
はんかがい	繁華街
はんかく	半角
はんがく	半額
はんかつう	半可通
はんかん	反感
ばんかん	万感
はんかんすう	汎関数
はんき	半旗
はんき	半期
はんぎゃく	反逆
はんきゅう	半球
はんきょう	反響
ばんきん	板金
ばんぐみ	番組
はんけい	半径
はんげき	反撃
はんけつ	判決
はんけん	半券
はんけん	版権
はんげん	半減
はんこ	判子
はんご	反語
はんこう	反抗
はんこう	犯行
ばんごう	番号
ばんこく	万国
ばんこっき	万国旗
ばんこん	晩婚
はんさ	煩瑣
はんざい	犯罪
ばんざい	万歳
はんざつ	繁雑
はんざつ	煩雑
はんさよう	反作用
ばんさん	晩餐
はんし	半紙
はんし	藩士
はんじ	判事
ばんじ	万事
はんした	版下
はんしはんしょう	半死半生
はんしゃ	反射
ばんしゃく	晩酌
はんしゅう	半周
ばんしゅう	晩秋
はんじゅく	半熟
ばんじゅく	晩熟
はんしゅつ	搬出
ばんしゅん	晩春
ばんしょ	板書
はんしょう	半焼
はんしょう	半鐘
はんじょう	繁盛
ばんしょう	万障
ばんじょう	盤上
ばんじょう	万丈
はんしょく	繁殖
はんしょくち	繁殖地
はんしん	半身
はんしんはんぎ	半信半疑
はんしんろん	汎神論
はんすう	半数
はんすう	反芻
はんせい	反省
ばんせい	晩成
ばんせい	蛮声
はんぜん	判然
ばんせん	番線
ばんぜん	万全
はんそ	反訴
はんそう	搬送
ばんそう	伴奏
はんそく	反則
はんそで	半袖
はんたい	反対
ばんだい	番台
はんだくおん	半濁音
はんだん	判断
ばんち	番地
ばんちゃ	番茶
はんちゅう	範疇
はんちょう	班長
はんつき	半月
はんてい	判定
はんてん	反転
はんてん	斑点
はんと	版図
はんとう	半島
はんどう	反動
ばんとう	番頭
はんどうたい	半導体
はんとうめい	半透明
はんとき	半時
はんどく	判読
はんとし	半年
はんにち	半日
はんにち	反日
はんにゃ	般若
はんにゃとう	般若湯
はんにゅう	搬入
はんにん	犯人
ばんにん	番人
ばんにん	万人
はんね	半値
ばんねん	晩年
はんのう	反応
ばんのう	万能
はんば	飯場
はんぱ	半端
はんばい	販売
はんばいき	販売機
ばんぱく	万博
はんぱつ	反発
はんはん	半々
はんぴれい	反比例
はんぷ	頒布
はんぷく	反復
ばんぶつ	万物
はんぶん	半分
ばんぺい	番兵
はんべつ	判別
はんぼう	繁忙
はんみ	半身
はんみょう	斑猫
ばんみん	万民
はんめい	判明
はんめん	半面
はんめん	反面
ばんめん	盤面
はんも	繁茂
はんもく	反目
はんもと	版元
はんもん	反問
はんもん	煩悶
ばんゆう	万有
はんよう	汎用
ばんらい	万雷
はんらく	反落
はんらん	反乱
はんらん	氾濫
はんりょ	伴侶
はんりょう	半量
はんれい	判例
はんれい	反例
はんれい	凡例
はんろ	坂路
はんろん	反論
ひ	引
ひ	曳
ひ	火
ひ	干
ひ	牽
ひ	惹
ひ	退
ひ	弾
ひ	灯
ひ	日
ひ	妃
ひ	比
ひ	碑
ひ	秘
ひ	非
ひ	陽
び	日
び	美
ひあい	悲哀
ひいき	贔屓
ひいで	秀で
ひいまご	曾孫
ひいらぎ	柊
ひいろ	緋色
ひうん	非運
ひえ	稗
ひえ	冷え
ひえこ	冷え込
びえん	鼻炎
ひか	光
ひか	皮下
ひが	僻
びか	美化
ひがい	被害
ひがいしゃ	被害者
ひかえ	控え
ひかえしつ	控室
ひがえり	日帰り
ひかく	比較
ひかく	皮革
びがく	美学
ひかげ	日陰
ひがし	東
ひがしがわ	東側
ひがしぐち	東口
ひがた	干潟
ひからび	干からび
ひかり	光
ひかん	悲観
ひがん	彼岸
ひがん	悲願
びかん	美観
ひき	引き
ひぎ	秘技
ひきあ	引き合
ひきあい	引合
ひきあい	引合い
ひきあげ	引き上げ
ひきあげ	引き揚げ
ひきあて	引当
ひきあわせ	引き合わせ
ひきい	率い
ひきうけ	引き受け
ひきうけ	引受
ひきうけ	引受け
ひきうつ	引き移
ひきうつ	引き写
ひきおと	引き落と
ひきおろ	引き下ろ
ひきかえ	引き替え
ひきかえ	引き返
ひきかえ	引換
ひきがえる	蟇蛙
ひきがね	引金
ひきこ	引き込
ひきさ	引きさ
ひきさ	引き裂
ひきさが	引き下が
ひきさげ	引き下げ
ひきさげ	引下げ
ひきざん	引き算
ひきざん	引算
ひきしお	引き潮
ひきしま	引き締ま
ひきしめ	引き締め
ひきず	引きず
ひきた	引き立
ひきだ	引き出
ひきだし	引出し
ひきたて	引立て
ひきつ	引き継
ひきつけ	引き付け
ひきつづ	引き続
ひきつづき	引続き
ひきでもの	引出物
ひきと	引き取
ひきとめ	引き止め
ひきとめ	引き留め
ひきにく	挽肉
ひきぬ	引き抜
ひきのば	引き延ば
ひきのば	引き伸ば
ひきはな	引き離
ひきふね	曳舟
ひきもど	引き戻
ひきゃく	飛脚
ひきょう	卑怯
ひきょう	比況
ひきょう	秘境
ひぎょう	罷業
ひきよせ	引き寄せ
ひきょり	飛距離
ひきわけ	引き分け
ひきわた	引き渡
ひきわたし	引渡し
ひきん	卑近
ひきんしつ	非均質
ひきんぞく	卑金属
ひく	低
ひくつ	卑屈
ひくめ	低め
ひげ	卑下
ひげ	髭
ひげ	鬚
ひげき	悲劇
ひけつ	否決
ひけつ	秘訣
ひけん	比肩
ひけんしゃ	被験者
ひご	庇護
ひご	籤
ひごい	緋鯉
ひこう	非行
ひこう	飛行
びこう	備考
びこう	尾行
ひこうき	飛行機
ひこうじょう	飛行場
ひごかん	非互換
ひこく	被告
ひごと	日毎
ひごろ	日頃
ひさ	久
ひさ	鬻
ひざ	膝
ひさい	被災
びさい	微細
ひさし	久し
ひさし	庇
ひざし	日差
ひざし	日差し
ひざし	日射
ひざし	日射し
ひざし	陽射
ひざし	陽射し
ひさしぶり	久しぶり
ひさびさ	久々
ひさん	悲惨
ひさん	飛散
ひし	菱
ひじ	肱
ひじ	肘
びし	微視
ひしがた	菱形
びしつ	美質
ひしゃ	飛車
ひしゃく	柄杓
びじゃく	微弱
ひしゃたい	被写体
びしゅ	美酒
ひじゅう	比重
びしゅう	美醜
ひじゅつ	秘術
びじゅつ	美術
びじゅつかん	美術館
ひじゅん	批准
ひしょ	秘書
ひしょ	避暑
びじょ	美女
ひしょう	飛翔
ひじょう	非常
ひじょう	非情
びしょう	微小
びしょう	微笑
ひじょうぐち	非常口
ひじょうしき	非常識
びしょく	美食
ひじり	聖
びしん	微震
びじん	美人
ひず	歪
びせきぶん	微積分
ひぜに	日銭
ひせん	卑賎
ひせん	卑賤
ひせんけい	非線形
ひそ	潜
ひそ	砒素
ひそ	顰
ひそう	悲壮
ひそう	皮相
ひぞう	秘蔵
ひぞう	脾臓
ひそか	窃か
ひそか	秘か
ひそか	密か
ひぞく	卑俗
ひぞく	卑属
びそく	微速
ひそめ	潜め
ひそめ	顰め
ひた	浸
ひだ	襞
ひたい	額
ひだい	肥大
ひだち	肥立ち
ひだまり	日溜り
ひだり	左
ひだりあし	左足
ひだりうえ	左上
ひだりうで	左腕
ひだりがわ	左側
ひだりした	左下
ひだりて	左手
ひだりめ	左目
ひたん	悲嘆
びだん	美談
ひだんけいし	避弾経始
ひちゅう	秘中
ひつあつ	筆圧
ひつう	悲痛
ひっか	引っか
ひっか	筆禍
ひっかか	引っかか
ひっかけ	引っかけ
ひっき	筆記
ひつぎ	棺
ひっきょう	畢竟
ひっくりかえ	ひっくり返
ひっくるめ	引っくるめ
ひづけ	日付
ひっけい	必携
ひっけん	必見
ひっこ	引っ越
ひっこ	引っ込
ひっこう	筆耕
ひっこし	引越し
ひっこみ	引込み
ひっさつ	必殺
ひっし	必死
ひっし	必至
ひつじ	未
ひつじ	羊
ひつじどし	未年
ひっしゃ	筆写
ひっしゃ	筆者
ひつじゅ	必需
ひっしゅう	必修
ひつじゅん	筆順
ひっしょう	必勝
ひつじょう	必定
ひっす	必須
ひっせい	畢生
ひっせき	筆跡
ひつぜつ	筆舌
ひつぜん	必然
ひっそく	逼塞
ひつだん	筆談
ひっち	筆致
ひっちゃく	必着
ひっちゅう	必中
ひっちょう	必聴
ひってき	匹敵
ひっとう	筆頭
ひつどく	必読
ひっぱ	引っ張
ひっぱく	逼迫
ひっぱり	引張
ひづめ	蹄
ひつよう	必要
ひてい	否定
びてき	美的
ひてつ	非鉄
ひでり	日照り
ひでん	秘伝
びてん	美点
ひと	人
ひと	他人
ひど	酷
ひとあし	一足
ひといちばい	人一倍
ひとう	秘湯
ひどうき	非同期
ひとえ	一重
ひとえ	単
ひとかげ	人影
ひとかたならず	一方ならず
ひとかたならぬ	一方ならぬ
ひとがら	人柄
ひとぎき	人聞き
ひとく	秘匿
びとく	美徳
ひとくち	一口
ひどけい	日時計
ひとこと	一言
ひとごと	人事
ひとごと	他人事
ひとごみ	人込み
ひとごみ	人混み
ひところ	一頃
ひとさしゆび	人差指
ひとざと	人里
ひとさらい	人拐い
ひとさらい	人攫い
ひとさわがせ	人騒がせ
ひとし	均し
ひとし	等し
ひとじち	人質
ひとしなみ	等し並み
ひとすじ	一筋
ひとすじなわ	一筋縄
ひとたち	人達
ひとたび	一度
ひとちがい	人違い
ひとつ	一つ
ひとづま	人妻
ひとで	人手
ひとで	人出
ひととおり	一通り
ひととき	一時
ひとなみ	人並
ひとはだ	一肌
ひとはだ	人肌
ひとばん	一晩
ひとびと	人びと
ひとびと	人々
ひとまえ	人前
ひとまく	一幕
ひとまわり	一回り
ひとみ	瞳
ひとり	一人
ひとり	独り
ひどり	日取り
ひとりごと	独り言
ひとりじめ	一人占め
ひとりじめ	独り占め
ひとりっこ	一人っ子
ひとりぼっち	一人ぼっち
ひな	雛
ひなた	日向
ひなわじゅう	火縄銃
ひなん	避難
ひなん	非難
びなん	美男
ひにく	皮肉
ひにち	日にち
ひにち	日日
ひにょう	泌尿
ひにょうき	泌尿器
ひにん	否認
ひにん	避妊
ひね	捻
びねつ	微熱
ひのえ	丙
ひのき	桧
ひのこ	火の粉
ひので	日の出
ひのと	丁
ひばく	被曝
ひばしら	火柱
ひばち	火鉢
ひばな	火花
ひばり	雲雀
ひはん	批判
ひばん	非番
ひび	響
ひび	日々
びび	微々
ひびか	響か
びびし	美々し
ひひょう	批評
ひびわれ	ひび割れ
びひん	備品
ひふ	皮膚
ひぶ	日歩
ひふく	被服
ひぶた	火蓋
ひふん	悲憤
ひぶん	非文
ひへい	疲弊
ひほう	悲報
ひほう	秘宝
ひほう	秘法
ひぼう	誹謗
びぼう	美貌
びぼうろく	備忘録
ひぼん	非凡
ひま	暇
ひまく	皮膜
ひましゆ	ひまし油
ひまつ	飛抹
ひまわり	向日葵
ひまん	肥満
びまん	瀰漫
ひみつ	秘密
びみょう	微妙
ひめ	秘め
ひめ	姫
ひめい	悲鳴
びめい	美名
ひめん	罷免
ひも	紐
ひもく	費目
ひもと	火元
ひもの	干物
ひや	冷や
ひやあせ	冷汗
ひやか	冷やか
ひゃく	百
ひやく	飛躍
びやく	媚薬
ひゃくしょう	百姓
ひゃくぶん	百聞
ひゃくぶんりつ	百分率
ひゃくめんそう	百面相
びゃくや	白夜
ひやけ	日焼け
ひゃっか	百科
ひゃっかてん	百貨店
ひゃっかりょうらん	百花繚乱
ひやむぎ	冷麦
ひややか	冷やか
ひややっこ	冷奴
ひゆ	比喩
ひゆうり	非有理
ひょう	標
ひょう	氷
ひょう	票
ひょう	表
ひょう	評
ひょう	豹
ひょう	雹
ひよう	費用
びょう	秒
びょう	鋲
びよう	美容
ひょうい	表意
ひょうい	憑依
びょういん	病院
ひょうおん	表音
ひょうか	評価
ひょうが	氷河
びょうが	描画
ひょうかい	氷解
ひょうかん	慓悍
ひょうき	標記
ひょうき	表記
ひょうぎ	評議
びょうき	病気
ひょうきん	剽軽
ひょうけい	表敬
ひょうけつ	票決
ひょうけつ	表決
びょうけつ	病欠
ひょうげん	氷原
ひょうげん	表現
ひょうげん	評言
びょうげん	病原
びょうげんきん	病原菌
びょうげんきん	病源菌
ひょうご	標語
ひょうこう	標高
ひょうさつ	表札
ひょうざん	氷山
ひょうし	拍子
ひょうし	表紙
ひょうじ	表示
びょうし	病死
ひょうしき	標識
びょうしつ	病室
びょうしゃ	描写
ひょうしゃく	評釈
びょうじゃく	病弱
ひょうしゅつ	表出
ひょうじゅん	標準
ひょうじゅんか	標準化
ひょうじゅんけい	標準形
ひょうしょう	表彰
ひょうしょう	表象
ひょうじょう	表情
ひょうじょう	評定
びょうしょう	病床
びょうじょう	病状
びょうしん	病身
びょうしん	秒針
ひょうせつ	剽窃
ひょうそう	表層
びょうそう	病巣
ひょうそく	平仄
びょうそく	秒速
ひょうだい	表題
ひょうたん	瓢箪
ひょうちゃく	漂着
ひょうてい	標定
ひょうてい	評定
ひょうてき	標的
びょうてき	病的
ひょうてん	氷点
ひょうてん	評点
ひょうでん	票田
ひょうでん	評伝
ひょうど	表土
びょうとう	病棟
びょうどう	平等
びょうにん	病人
ひょうはく	漂泊
ひょうはく	漂白
ひょうばん	評判
ひょうひ	表皮
びょうぶ	屏風
ひょうへん	豹変
ひょうぼう	標榜
びょうぼつ	病没
ひょうほん	標本
びょうま	病魔
ひょうめい	表明
びょうめい	病名
ひょうめん	表面
ひょうめんは	表面波
ひょうり	表裏
びょうり	病理
ひょうりゅう	漂流
びょうれき	病歴
ひょうろう	兵糧
ひょうろん	評論
ひよく	肥沃
びよく	尾翼
ひよどり	鵯
ひより	日和
びより	日和
ひよわ	ひ弱
ひら	開
ひらあやまり	平謝り
ひらい	避雷
ひらいしん	避雷針
ひらおよぎ	平泳ぎ
ひらがな	平仮名
ひらきなお	開きなお
ひらきなお	開き直
ひらぞこ	平底
ひらた	平た
ひらめ	閃
ひらめ	鮃
ひりき	非力
ひりつ	比率
びりゅう	微粒
ひりょう	肥料
びりょう	微量
ひりょく	非力
ひりょく	臂力
びりょく	微力
ひる	怯
ひる	昼
ひる	蛭
ひるい	比類
ひるがえ	翻
ひるげ	昼餉
ひるね	昼寝
ひるま	昼間
ひるめし	昼飯
ひるやすみ	昼休み
ひれ	鰭
ひれい	比例
ひれき	披瀝
ひれつ	卑劣
ひれふ	ひれ伏
ひれん	悲恋
ひろ	広
ひろ	拾
ひろ	汎
ひろう	披露
ひろう	疲労
びろう	尾篭
ひろうえん	披露宴
ひろが	広が
ひろげ	広げ
ひろば	広場
ひろびろ	広々
ひろま	広ま
ひろま	広間
ひろめ	広め
ひわ	秘話
びわ	琵琶
ひわり	日割
ひわれ	干割れ
ひん	品
ひん	瀕
ひん	貧
びん	瓶
びん	便
びん	壜
ひんい	品位
ひんかく	品格
びんかん	敏感
ひんきゃく	賓客
ひんきゅう	貧窮
ひんきゅう	殯宮
ひんけつ	貧血
ひんこう	品行
ひんこん	貧困
ひんし	品詞
ひんし	瀕死
ひんしつ	品質
ひんじゃ	貧者
ひんじゃく	貧弱
ひんしゅ	品種
ひんしゅく	顰蹙
ひんしゅつ	頻出
びんしょう	敏捷
びんしょう	憫笑
びんじょう	便乗
ひんせい	品性
びんせん	便箋
ひんそう	貧相
びんそく	敏速
びんぞこ	瓶底
ひんど	頻度
ひんば	牝馬
ひんぱつ	頻発
ひんぱん	頻繁
ひんぷ	貧富
びんぼう	貧乏
ひんみん	貧民
ひんめい	品名
ひんもく	品目
びんらん	便覧
びんわん	敏腕
ふ	臥
ふ	降
ふ	拭
ふ	振
ふ	吹
ふ	践
ふ	踏
ふ	付
ふ	府
ふ	符
ふ	譜
ふ	負
ふ	賦
ふ	附
ふ	葺
ふ	伏
ふ	噴
ふ	麸
ぶ	部
ぶ	分
ぶあい	歩合
ぶあいそう	無愛想
ぶあつ	分厚
ふあん	不安
ふあんてい	不安定
ふい	不意
ふいちょう	吹聴
ふいっち	不一致
ぶいん	部員
ふう	封
ふう	風
ふうあつ	風圧
ふういん	封印
ふうう	風雨
ふううん	風雲
ふうか	風化
ふうが	風雅
ふうかく	風格
ふうがわり	風変わり
ふうき	富貴
ふうき	封切
ふうき	風紀
ふうぎ	封切
ふうきょう	風狂
ふうきり	封切り
ふうけい	風景
ふうこう	風光
ふうこう	風向
ふうさ	封鎖
ふうさい	風采
ふうさつ	封殺
ふうし	風刺
ふうし	諷刺
ふうじこ	封じ込
ふうじこめ	封じ込め
ふうしゃ	風車
ふうしゅう	風習
ふうしょ	封書
ふうしん	風疹
ふうせつ	風雪
ふうせん	風船
ふうそく	風速
ふうぞく	風俗
ふうたい	風袋
ふうちょう	風潮
ふうてい	風体
ふうど	風土
ふうとう	封筒
ふうどう	風洞
ふうふ	夫婦
ふうぶつ	風物
ふうぶつし	風物詩
ふうぼう	風貌
ふうぼう	風防
ふうみ	風味
ふうりゅう	風流
ふうりょく	風力
ふうりん	風鈴
ふうん	不運
ふえ	殖え
ふえ	増え
ふえ	笛
ふえい	府営
ふえて	不得手
ふえん	敷衍
ぶえんりょ	無遠慮
ふおん	不穏
ふか	更か
ふか	蒸か
ふか	深
ふか	不可
ふか	付加
ふか	府下
ふか	負荷
ふか	鯊
ふか	鱶
ぶか	部下
ふかい	不快
ぶかい	部会
ぶがい	部外
ぶがいひ	部外秘
ふかかい	不可解
ふかぎゃく	不可逆
ふかく	不覚
ふかく	俯角
ふかけつ	不可欠
ふかしぎ	不可思議
ふかしん	不可侵
ふかち	不可知
ぶかちょう	部課長
ふかつ	賦活
ふかのう	不可能
ふかひ	不可避
ふかぶかと	深々と
ふかぶん	不可分
ふかま	深ま
ふかめ	深め
ふかん	俯瞰
ぶかん	武官
ふかんしょう	不干渉
ふかんしょう	不感症
ふかんぜん	不完全
ふき	付記
ふき	附記
ふき	蕗
ふぎ	不義
ふぎ	付議
ぶき	武器
ふきあれ	吹き荒れ
ふきかえ	吹き返
ふきかえ	吹替え
ふきかけ	吹きかけ
ふきげん	不機嫌
ふきこ	吹き込
ふきそ	不起訴
ふきそく	不規則
ふきだ	吹き出
ふきだまり	吹き溜り
ふきつ	不吉
ふきつけ	吹き付け
ふきでもの	吹出物
ふきと	拭き取
ふきとば	吹き飛ば
ふきなが	吹き流
ふきぬけ	吹抜け
ぶきみ	不気味
ふきゅう	不休
ふきゅう	不朽
ふきゅう	普及
ふきょう	不況
ふきょう	布教
ぶきよう	不器用
ぶぎょう	奉行
ぶきょく	部局
ぶきりょう	不器量
ふきん	付近
ふきん	布巾
ふきんこう	不均衡
ふきんしん	不謹慎
ふく	含
ふく	伏
ふく	復
ふく	服
ふく	福
ふぐ	河豚
ふぐ	鰒
ふぐあい	不具合
ふくいん	福音
ふぐう	不遇
ふくえき	服役
ふくえん	復縁
ふくがく	復学
ふくかん	副官
ふくぎょう	副業
ふくげん	復元
ふくごう	復号
ふくごう	複合
ふくさい	副菜
ふくざつ	複雑
ふくさよう	副作用
ふくさんぶつ	副産物
ふくし	副詞
ふくし	福祉
ふくじ	副次
ふくじ	服地
ふくしき	腹式
ふくしき	複式
ふくしゃ	複写
ふくしゅう	復習
ふくしゅう	復讐
ふくじゅう	服従
ふくしょう	副将
ふくしょう	副賞
ふくしょう	復唱
ふくしょう	複勝
ふくしょく	副食
ふくしょく	復職
ふくしょく	服飾
ふくしん	副審
ふくしん	腹心
ふくじんづけ	福神漬
ふくすい	覆水
ふくすう	複数
ふくすうこ	複数個
ふくせい	複製
ふくせん	伏線
ふくせん	複線
ふくそう	服装
ふくそう	輻輳
ふくぞく	服属
ふくそすう	複素数
ふくだい	副題
ふぐたいてん	不倶載天
ふくつ	不屈
ふくつう	腹痛
ふくどく	副読
ふくどく	服毒
ふくびき	福引
ふくへい	伏兵
ふくほん	副本
ふくほん	複本
ふくまく	腹膜
ふくむ	服務
ふくめ	含め
ふくめん	覆面
ふくやく	服薬
ふくよう	服用
ふくようき	複葉機
ふくら	膨ら
ふくり	福利
ふくり	複利
ふくれ	膨れ
ふくろ	袋
ふくろ	復路
ぶくろ	袋
ふくろう	梟
ふくろおび	袋帯
ふくろこうじ	袋小路
ふけ	更け
ふけ	耽
ふけ	老け
ふけい	婦警
ふけい	父兄
ふけいき	不景気
ふけいざい	不経済
ふけこ	老け込
ふけつ	不潔
ふけん	府県
ふげん	付言
ふけんこう	不健康
ふけんぜん	不健全
ふこう	不孝
ふこう	不幸
ふごう	富豪
ふごう	符号
ふごう	符合
ふごうかく	不合格
ふこうへい	不公平
ふごうり	不合理
ふこく	布告
ぶこく	誣告
ふこくきょうへい	富国強兵
ふこころえ	不心得
ぶこつ	武骨
ふさ	塞
ふさ	房
ふさい	夫妻
ふさい	負債
ふざい	不在
ぶさいく	不細工
ふさいよう	不採用
ふさが	塞が
ふさく	不作
ぶさほう	無作法
ぶざま	不様
ふさわし	相応し
ふさんか	不参加
ふさんせい	不賛成
ふし	節
ふじ	藤
ふじ	不時
ふじ	不治
ぶし	武士
ぶじ	無事
ふしあわせ	不幸せ
ふしぎ	不思議
ふしぜん	不自然
ふじちゃく	不時着
ふしちょう	不死鳥
ぶしつ	部室
ぶしつけ	不躾
ふしぶし	節々
ふしまつ	不始末
ふじみ	不死身
ふしめ	節目
ふしゃ	富者
ぶしゅ	部首
ふしゅう	腐臭
ふじゆう	不自由
ふじゅうぶん	不充分
ふじゅうぶん	不十分
ふしゅつ	不出
ふしゅび	不首尾
ふじゅん	不純
ふじゅん	不順
ふじょ	婦女
ふじょ	扶助
ぶしょ	部所
ぶしょ	部署
ふしょう	不詳
ふしょう	負傷
ふじょう	不浄
ふじょう	浮上
ぶしょう	不精
ぶしょう	武将
ふしょうじ	不祥事
ふしょうふずい	夫唱婦随
ふしょく	腐食
ぶじょく	侮辱
ふしょくふ	不織布
ふじょし	婦女子
ふしん	不信
ふしん	不審
ふしん	不振
ふしん	普請
ふしん	腐心
ふじん	夫人
ふじん	婦人
ふしんせつ	不親切
ふしんにん	不信任
ふず	付図
ふずい	不随
ふずい	付随
ぶすい	不粋
ふすう	負数
ぶすう	部数
ふすま	襖
ふせ	臥せ
ふせ	布施
ふせ	伏せ
ふせ	防
ふせい	不省
ふせい	不整
ふせい	不正
ふせい	不斉
ふぜい	風情
ふせいりつ	不成立
ふせき	布石
ふせじ	伏せ字
ふせじ	伏字
ふせつ	付設
ふせつ	敷設
ふせん	不戦
ふせん	付箋
ふぜん	不全
ふせんしょう	不戦勝
ふせんぱい	不戦敗
ふそ	父祖
ぶそう	武装
ふそうおう	不相応
ふそく	不足
ふそく	付則
ふそく	附則
ふぞく	付属
ふぞく	附属
ぶそく	不足
ぶぞく	部族
ふそくふり	不即不離
ふぞろい	不揃い
ふそん	不尊
ふそん	不遜
ふた	蓋
ふだ	札
ぶた	豚
ふたい	付帯
ふだい	譜代
ぶたい	舞台
ぶたい	部隊
ふたえ	二重
ふたく	付託
ふたく	負託
ふたご	双子
ふたたび	再び
ふたつ	二つ
ぶたにく	豚肉
ふたば	双葉
ふたり	二人
ふたりして	二人して
ふたん	負担
ふだん	不断
ふだん	普段
ふだんぎ	普段着
ふち	縁
ふち	付置
ふち	淵
ぶち	斑
ふちゃく	付着
ふちゅうい	不注意
ふちょう	不調
ふちょう	婦長
ふちょう	府庁
ふちょう	符丁
ぶちょう	部長
ぶつ	物
ふつう	不通
ふつう	普通
ふつか	2日
ふつか	２日
ふつか	二日
ぶっか	物価
ぶっかく	仏閣
ふっかけ	ふっ掛け
ふっかけ	吸っ掛け
ふっかつ	復活
ふつかよい	宿酔い
ふっき	ふっ切
ふっき	吸っ切
ふっき	復帰
ふづき	文月
ぶつぎ	物議
ふっきゅう	復仇
ふっきゅう	復旧
ぶっきょう	仏教
ふっきん	腹筋
ふっけん	復権
ぶっけん	物件
ふっこ	復古
ふっこう	復興
ふっこう	復交
ふつごう	不都合
ふっこく	復刻
ぶっさん	物産
ぶっし	仏師
ぶっし	物資
ぶっしつ	物質
ぶっしょう	物証
ふっしょく	払拭
ぶっしょく	物色
ぶっしん	仏心
ぶっしん	物心
ぶっせい	物性
ぶっそう	物騒
ぶつぞう	仏像
ぶっだ	仏陀
ぶったい	物体
ぶったぎ	ぶった切
ぶつだん	仏壇
ぶっちょうづら	仏頂面
ふつつか	不束
ふってい	払底
ぶってき	物的
ふってん	沸点
ふっと	ふっ飛
ぶっと	ぶっ飛
ふっとう	沸騰
ぶつどう	仏道
ぶっとお	ぶっ通
ぶっぴん	物品
ぶつめつ	仏滅
ぶつり	物理
ぶつりがく	物理学
ぶつりょう	物療
ぶつりょう	物量
ふで	筆
ふてい	不貞
ふてい	不定
ふてい	不逞
ふてき	不敵
ふてき	不適
ふでき	不出来
ふてきせつ	不適切
ふてぎわ	不手際
ふでぶしょう	筆不精
ふでまめ	筆まめ
ふと	太
ふとう	不当
ふとう	不等
ふとう	埠頭
ふどう	不動
ふどう	不同
ふどう	浮動
ぶどう	武道
ぶどう	葡萄
ふどうさん	不動産
ふどうたい	不導体
ふどうとく	不道徳
ふとく	不徳
ふとくい	不得意
ふところ	懐
ふところで	懐手
ふとじ	太字
ふとっぱら	太っ腹
ぶどまり	歩留まり
ぶどまり	歩留り
ふとめ	太め
ふとん	蒲団
ふとん	布団
ふな	鮒
ぶな	山毛欅
ぶな	椈
ふない	府内
ぶない	部内
ふなくぎ	舟釘
ふなぞこ	船底
ふなたび	船旅
ふなで	船出
ふなに	船荷
ふなのり	船乗り
ふなびん	船便
ふなむし	舟虫
ふなよい	船酔い
ふなれ	不慣れ
ぶなん	無難
ふにく	腐肉
ふにん	不妊
ふにん	赴任
ふぬけ	腑抜け
ふね	舟
ふね	船
ぶね	船
ふねん	不燃
ふねん	不稔
ふのう	不能
ふはい	不敗
ふはい	腐敗
ふはつ	不発
ふび	不備
ぶひ	部費
ふひつよう	不必要
ふひょう	不評
ふひょう	付表
ふひょう	附票
ふひょう	歩兵
ふびょうどう	不平等
ふびん	不憫
ぶひん	部品
ぶふうりゅう	無風流
ふぶき	吹雪
ふふく	不服
ぶぶん	部分
ふへい	不平
ぶべつ	侮蔑
ふへん	不変
ふへん	普遍
ふべん	不便
ふぼ	父母
ふほう	不法
ふほう	訃報
ふほんい	不本意
ふまえ	踏まえ
ふまん	不満
ふみ	文
ふみえ	踏み絵
ふみき	踏み切
ふみきり	踏切
ふみこ	踏み込
ふみだ	踏み出
ふみだい	踏台
ふみたお	踏み倒
ふみづき	文月
ふみつけ	踏みつけ
ふみとどま	踏みとどま
ふみにじ	踏みにじ
ふみはず	踏み外
ふみん	不眠
ふむき	不向き
ふめい	不明
ふめいかく	不明確
ふめいよ	不名誉
ふめいりょう	不明瞭
ふめつ	不滅
ふめん	譜面
ふもう	不毛
ふもと	麓
ふもん	不問
ぶもん	部門
ふや	殖や
ふや	増や
ふゆ	冬
ふゆう	富裕
ふゆう	浮遊
ふゆかい	不愉快
ふゆきとどき	不行届き
ふゆば	冬場
ふゆふく	冬服
ふゆもの	冬物
ふゆやすみ	冬休み
ふゆやま	冬山
ふよ	付与
ふよう	不用
ふよう	不要
ふよう	扶養
ふよう	浮揚
ぶよう	舞踊
ふようい	不用意
ぶようじん	不用心
ふようど	腐葉土
ぶらい	不頼
ぶらうんかん	ブラウン管
ぶらく	部落
ぶらさが	ぶら下が
ぶらさげ	ぶら下げ
ふらん	不乱
ふらん	腐乱
ふり	不利
ぶり	鰤
ふりえき	不利益
ふりかえ	振り替え
ふりかえ	振り返
ふりかえ	振替
ぶりかえ	ぶり返
ふりかか	降り掛か
ふりかけ	振りかけ
ふりかた	振り方
ふりがな	振り仮名
ふりき	振り切
ふりこ	振り込
ふりこみ	振込
ふりそそ	降り注
ふりそで	振袖
ふりだ	降り出
ふりだ	振り出
ふりだし	振出
ふりつ	府立
ふりつけ	振付け
ふりはら	振り払
ふりま	振りま
ふりまわ	振り回
ふりみだ	振り乱
ふりむ	振り向
ふりょ	不慮
ふりょう	不漁
ふりょう	不良
ふりょく	浮力
ぶりょく	武力
ふりわけ	振り分け
ふりん	不倫
ふる	旧
ふる	古
ふる	振る
ふる	震
ふる	奮
ふる	篩
ふるい	篩
ぶるい	部類
ふるいおこ	奮い起こ
ふるいおと	ふるい落と
ふるいた	奮い立
ふるいわけ	ふるい分け
ふるえ	震え
ふるえあが	震え上が
ふるぎ	古着
ふるくさ	古くさ
ふるさと	古里
ふるす	古巣
ふるて	古手
ふるび	古び
ふるほん	古本
ふるま	振る舞
ふるまい	振舞
ふるめかし	古めかし
ふるや	古屋
ふるわ	震わ
ふれ	触れ
ふれあ	触れ合
ふれあい	ふれ合い
ぶれい	無礼
ぶれいこう	無礼講
ふれこ	触れ込
ふれんぞく	不連続
ふろ	風呂
ぶろ	風呂
ふろう	不労
ふろう	不老
ふろう	浮浪
ふろく	付録
ふろしき	風呂敷
ふわ	不和
ふわく	不惑
ふわたり	不渡り
ふわらいどう	付和雷同
ふん	分
ふん	憤
ふん	扮
ふん	糞
ぶん	分
ぶん	文
ぶんい	文意
ふんいき	雰囲気
ふんえん	噴煙
ぶんえん	分煙
ふんか	噴火
ぶんか	分化
ぶんか	分科
ぶんか	文化
ぶんか	文科
ふんがい	憤慨
ぶんかい	分会
ぶんかい	分解
ぶんがく	文学
ぶんがく	文學
ぶんがくぶ	文学部
ぶんかざい	文化財
ぶんかつ	分割
ぶんかん	分館
ぶんかん	文官
ふんき	噴気
ふんき	奮起
ふんぎ	ふん切
ぶんき	分岐
ぶんきょう	文教
ぶんぎょう	分業
ぶんぐ	文具
ぶんけ	分家
ぶんけい	文型
ぶんけい	文系
ぶんげい	文芸
ぶんげい	文藝
ぶんけん	文献
ぶんこ	文庫
ぶんご	文語
ぶんこう	分校
ぶんごう	文豪
ぶんこつ	分骨
ふんさい	粉砕
ぶんさい	文才
ぶんさつ	分冊
ぶんさん	分散
ぶんし	分子
ぶんし	分詞
ふんしつ	紛失
ぶんしつ	分室
ふんしゃ	噴射
ぶんしゃ	分社
ぶんしゅう	文集
ふんしゅつ	噴出
ふんしょ	焚書
ぶんしょ	文書
ぶんしょう	文章
ぶんじょう	分譲
ふんしょく	粉飾
ぶんしん	分身
ふんすい	噴水
ぶんすいれい	分水嶺
ぶんすう	分数
ぶんせき	分析
ぶんせき	文責
ぶんせつ	分節
ぶんせつ	文節
ふんぜん	憤然
ふんぜん	奮然
ふんそう	扮装
ふんそう	紛争
ふんぞりかえ	ふんぞり返
ぶんたい	分隊
ぶんたい	文体
ぶんたん	分担
ぶんだん	分断
ぶんだん	文壇
ぶんち	分置
ぶんちゅう	文中
ぶんつう	文通
ふんとう	奮闘
ふんどう	分銅
ふんどし	褌
ふんにゅう	粉乳
ぶんのう	分納
ふんば	踏ん張
ぶんぱ	分派
ぶんぱい	分配
ふんぱつ	奮発
ふんぱん	噴飯
ぶんぴつ	分泌
ぶんぴつ	分筆
ぶんぴつ	文筆
ぶんぶ	文武
ぶんぷ	分布
ぶんぶつ	文物
ふんぷん	紛々
ふんべつ	分別
ぶんべつ	分別
ぶんべん	分娩
ぶんぼ	分母
ぶんぽう	文法
ぶんぼうぐ	文房具
ふんまつ	粉末
ぶんまつ	文末
ふんまん	噴懣
ぶんみゃく	文脈
ぶんみん	文民
ぶんめい	文明
ぶんめん	文面
ぶんや	分野
ぶんよ	分与
ぶんらく	文楽
ぶんり	分離
ぶんりつ	分立
ぶんりょう	分量
ぶんるい	分類
ぶんれい	文例
ぶんれつ	分裂
へ	経
へ	減
へい	丙
へい	兵
へい	塀
へいあん	平安
へいい	平易
へいえい	併映
へいえき	兵役
へいおん	平穏
へいか	平価
へいか	陛下
べいか	米価
へいかい	閉会
へいがい	弊害
へいかん	閉館
へいき	併記
へいき	兵器
へいき	平気
へいきん	平均
へいきんち	平均値
へいきんてん	平均点
べいぐん	米軍
へいけ	平家
へいけい	閉経
へいげい	睥睨
へいげん	平原
へいこう	併行
へいこう	平行
へいこう	平衡
へいこう	並行
へいこう	閉口
へいこう	閉校
へいごう	併合
へいこうしへんけい	平行四辺形
へいこうせん	平行線
へいさ	閉鎖
べいさく	米作
へいざん	閉山
へいし	兵士
へいじ	平時
べいしきしゅうきゅう	米式蹴球
へいじつ	平日
へいしゃ	兵舎
へいしゃ	弊社
べいじゅ	米寿
へいしゅうごう	閉集合
へいしょ	閉所
へいじょう	平常
へいじょう	閉場
べいしょく	米食
へいしん	平身
へいしん	並進
へいせい	平静
へいせつ	併設
へいぜん	平然
へいそ	平素
へいそく	閉塞
へいそん	併存
へいたい	兵隊
へいたん	平坦
へいち	平地
へいち	並置
へいちょう	閉庁
へいてい	平定
へいてい	閉廷
へいてん	弊店
へいてん	閉店
へいどん	併呑
へいねつ	平熱
へいねん	平年
へいばい	併売
へいはつ	併発
へいはん	平版
へいばん	平板
べいはん	米飯
へいふく	平伏
へいふく	平服
へいほう	兵法
へいほう	平方
へいぼん	平凡
へいまく	閉幕
へいみん	平民
へいめい	平明
へいめん	平面
へいもん	閉門
へいや	平野
へいゆ	平癒
へいゆう	併有
へいよう	併用
へいりつ	並立
へいりょく	兵力
へいれつ	並列
へいろ	閉路
へいわ	平和
ぺーじ	頁
へき	僻
へき	壁
へき	癖
へき	碧
へきえき	辟易
へきが	壁画
べきしゅうごう	冪集合
へきそん	僻村
へきち	僻地
へきとう	劈頭
へきめん	壁面
へきれき	霹靂
へさき	舳先
へそ	臍
へそまがり	へそ曲がり
へた	下手
へだた	隔た
へだて	隔て
べつ	別
べっかく	別格
べっかん	別巻
べっかん	別館
べっき	別記
べつぎ	別儀
べっきょ	別居
べつくち	別口
べっけん	別件
べっこ	別個
べっこう	別項
べっさつ	別冊
べっし	別紙
べっし	蔑視
べっしつ	別室
べっしゅ	別種
べっしょう	別称
べつじょう	別状
べつじん	別人
べっせい	別姓
べっそう	別荘
べっそう	別送
べったく	別宅
べつだん	別段
べっちゅう	別注
べっと	別途
べつのう	別納
べつばい	別売
べっぴょう	別表
べつびん	別便
べっぴん	別嬪
べつべつ	別々
べっぽう	別報
べつむね	別棟
べつめい	別名
べつもの	別物
べつり	別離
べに	紅
へび	蛇
へや	部屋
へら	減ら
へら	箆
へり	縁
へりくだ	遜
へん	偏
へん	変
へん	片
へん	編
へん	辺
べん	便
べん	弁
へんあつ	変圧
へんあつき	変圧器
へんい	変位
へんい	変移
べんえき	便益
へんか	変化
べんかい	弁解
へんかく	偏角
へんかく	変格
へんかく	変革
べんがく	勉学
へんかくかつよう	変格活用
へんかん	変換
へんかん	返還
べんぎ	便宜
べんぎじょう	便宜上
へんきゃく	返却
へんきょう	偏狭
へんきょう	辺境
べんきょう	勉強
へんきょく	編曲
へんきん	返金
へんくつ	偏屈
へんげ	変化
へんけい	変型
へんけい	変形
べんけい	弁慶
へんけん	偏見
べんご	弁護
へんこう	偏光
へんこう	偏向
へんこう	変更
へんこうてん	変更点
べんごし	弁護士
へんさ	偏差
へんさい	返済
へんざい	偏在
へんざい	遍在
べんさい	弁済
へんさん	編纂
へんし	変死
へんじ	返事
へんしつ	変質
へんしゅう	偏執
へんしゅう	編修
へんしゅう	編集
へんしゅうきょう	偏執狂
へんしょ	返書
べんじょ	便所
へんじょう	返上
べんしょう	弁償
へんしょく	偏食
へんしょく	変色
へんしん	変身
へんしん	返信
へんじん	変人
へんせい	変成
へんせい	変声
へんせい	編制
へんせい	編成
へんせん	変遷
へんそう	変奏
へんそう	変装
へんそう	返送
へんぞう	変造
へんそく	変則
へんそく	変速
へんたい	変体
へんたい	変態
へんたい	編隊
へんたいがな	変体仮名
べんたつ	鞭撻
へんち	辺地
へんちょう	偏重
へんちょう	変調
へんてこ	変てこ
へんてん	変転
へんとう	返答
へんどう	変動
べんとう	弁当
へんにゅう	編入
へんねん	編年
へんのう	返納
べんぱつ	弁髪
へんぴ	辺鄙
べんぴ	便秘
へんぴん	返品
へんぷ	返付
へんぺい	扁平
へんぺいそく	扁平足
べんべつ	弁別
へんぼう	変貌
べんぽう	便法
へんぽん	返本
べんむかん	弁務官
べんめい	弁明
へんよう	変容
べんらん	便覧
べんり	便利
べんり	弁理
べんりし	弁理士
へんりん	片鱗
へんれい	返戻
へんれい	返礼
べんれい	勉励
へんれき	遍歴
へんろ	遍路
べんろん	弁論
ほ	干
ほ	掘
ほ	彫
ほ	帆
ほ	保
ほ	歩
ほ	補
ぼ	戊
ほあん	保安
ほい	補遺
ほいく	保育
ぼいん	母音
ぼいん	拇印
ほう	報
ほう	奉
ほう	崩
ほう	放
ほう	方
ほう	法
ぼう	某
ぼう	棒
ほうあん	法案
ほうい	包囲
ほうい	方位
ほういがく	法医学
ぼういん	暴飲
ほうえい	放映
ぼうえい	防衛
ぼうえき	貿易
ぼうえき	防疫
ぼうえん	望遠
ぼうえん	防炎
ぼうえんきょう	望遠鏡
ほうおう	法王
ほうおう	法皇
ほうおう	鳳凰
ぼうおん	防音
ほうか	放火
ほうか	法科
ほうか	邦貨
ほうが	奉賀
ほうが	萌芽
ほうが	邦画
ぼうか	防火
ぼうが	忘我
ほうかい	崩壊
ほうがい	法外
ぼうがい	妨害
ぼうがい	望外
ほうかいしゃく	法解釈
ほうかいせき	方解石
ほうがく	方角
ほうがく	法学
ほうがく	邦楽
ほうがくぶ	法学部
ほうかご	放課後
ほうかつ	包括
ほうかん	宝冠
ほうかん	幇間
ほうがん	包含
ほうがん	方丸
ほうがん	方眼
ぼうかん	傍観
ぼうかん	暴漢
ぼうかん	防寒
ほうがんし	方眼紙
ほうき	放棄
ほうき	法規
ほうき	芳紀
ほうき	蜂起
ほうき	箒
ぼうきゃく	忘却
ぼうぎゃく	暴虐
ほうきゅう	俸給
ほうぎょ	崩御
ぼうきょ	暴挙
ぼうぎょ	防御
ぼうきょう	望郷
ぼうくう	防空
ぼうくうごう	防空壕
ほうけ	惚け
ほうけい	方形
ぼうけい	傍系
ほうげき	砲撃
ほうけん	封建
ほうげん	放言
ほうげん	方言
ぼうけん	冒険
ぼうげん	暴言
ほうこ	宝庫
ぼうご	防護
ほうこう	奉公
ほうこう	放校
ほうこう	方向
ほうこう	芳香
ほうこう	彷徨
ほうごう	縫合
ぼうこう	暴行
ほうこく	報告
ぼうさい	防災
ほうさく	方策
ほうさく	豊作
ぼうさつ	忙殺
ぼうさつ	謀殺
ほうさん	放散
ほうさん	硼酸
ほうし	奉仕
ほうし	法師
ほうし	胞子
ほうし	芳志
ほうじ	法事
ほうじ	焙じ
ぼうし	帽子
ぼうし	某氏
ぼうし	防止
ぼうじ	防磁
ほうしき	方式
ほうしゃ	放射
ぼうしゃ	某社
ほうしゃせい	放射性
ほうしゃせん	放射線
ほうしゃのう	放射能
ぼうしゅ	芒種
ぼうじゅ	傍受
ほうしゅう	報酬
ほうじゅう	放縦
ぼうしゅう	防臭
ぼうしゅうざい	防臭剤
ほうじゅく	豊熟
ほうしゅつ	放出
ほうじゅん	芳醇
ほうしょ	奉書
ほうじょ	幇助
ぼうしょ	某所
ほうしょう	報償
ほうしょう	報奨
ほうしょう	報賞
ほうしょう	褒賞
ほうじょう	豊饒
ぼうしょう	傍証
ぼうじょう	棒状
ほうしょく	奉職
ほうしょく	宝飾
ほうしょく	飽食
ぼうしょく	暴食
ほうしょくひん	宝飾品
ほうしん	放心
ほうしん	方針
ほうじん	方陣
ほうじん	法人
ほうじん	邦人
ぼうず	坊主
ほうすい	放水
ぼうすい	防水
ぼうすいけい	紡錘形
ほうせい	方正
ほうせい	縫製
ほうせき	宝石
ほうせつ	包接
ほうせん	法線
ぼうせん	防戦
ぼうぜん	呆然
ほうせんか	鳳仙花
ほうそ	硼素
ほうそう	包装
ほうそう	放送
ぼうそう	暴走
ほうそうかい	法曹界
ほうそうきょく	放送局
ほうそうし	包装紙
ほうそく	法則
ほうたい	包帯
ほうたい	方体
ほうだい	放題
ほうだい	邦題
ぼうだい	膨大
ぼうだち	棒立ち
ほうだん	放談
ほうだん	砲弾
ぼうだん	防弾
ほうち	報知
ほうち	放置
ほうち	法治
ほうちく	放逐
ほうちゃく	逢着
ほうちゅう	訪中
ぼうちゅう	傍注
ぼうちゅうざい	防虫剤
ほうちょう	包丁
ぼうちょう	傍聴
ぼうちょう	膨張
ほうてい	法定
ほうてい	法廷
ほうていしき	方程式
ほうてき	放擲
ほうてき	法的
ほうてき	抛擲
ほうでん	放電
ほうとう	宝刀
ほうとう	放蕩
ほうとう	砲塔
ほうどう	報道
ぼうとう	暴騰
ぼうとう	冒頭
ぼうどう	暴動
ほうどうじん	報道陣
ほうにち	訪日
ほうにん	放任
ほうねん	放念
ほうねん	豊年
ぼうねんかい	忘年会
ほうのう	奉納
ほうはい	澎湃
ほうばい	朋輩
ぼうばく	茫漠
ほうはつ	髣髪
ぼうはつ	暴発
ぼうはてい	防波堤
ほうび	褒美
ぼうび	防備
ほうふ	抱負
ほうふ	豊富
ぼうふ	防腐
ぼうふう	暴風
ぼうふう	防風
ぼうふうう	暴風雨
ほうふく	報復
ほうふつ	彷彿
ほうふつ	髣髴
ほうぶつせん	放物線
ほうぶん	邦文
ほうへい	砲兵
ほうべい	訪米
ぼうへき	防壁
ほうべん	方便
ほうほう	方法
ほうぼう	方々
ほうぼく	放牧
ほうまん	放漫
ほうまん	豊満
ほうむ	葬
ほうむ	法務
ほうめい	芳名
ぼうめい	亡命
ほうめん	放免
ほうめん	方面
ほうもつ	宝物
ほうもん	訪問
ほうもんぎ	訪問着
ぼうや	坊や
ほうやく	邦訳
ほうゆう	朋友
ほうよう	包容
ほうよう	抱擁
ほうよう	法要
ぼうよう	芒洋
ほうらく	包絡
ほうらく	崩落
ぼうらく	暴落
ぼうり	暴利
ほうりつ	法律
ぼうりゃく	謀略
ほうりゅう	放流
ぼうりょく	暴力
ほうれい	法令
ぼうれい	亡霊
ほうれんそう	法蓮草
ほうれんそう	菠薐草
ほうろう	放浪
ぼうろん	暴論
ほうわ	飽和
ほえ	吠え
ほお	頬
ほおべに	頬紅
ほおぼね	頬骨
ほおん	保温
ほか	外
ほか	他
ぼか	簿価
ぼか	暈
ほかく	保革
ほかく	捕獲
ほかならぬ	他ならぬ
ほがらか	朗らか
ほかん	保管
ほかん	補完
ほかん	補間
ぼかん	母艦
ほき	補記
ぼき	簿記
ほきゅう	補給
ほきょう	補強
ほきん	保菌
ぼきん	募金
ぼく	僕
ぼく	卜
ほくい	北緯
ほくぐん	北軍
ほくげん	北限
ぼくさつ	撲殺
ぼくし	牧師
ぼくしゅ	墨守
ぼくじゅう	墨汁
ほくじょう	北上
ぼくじょう	牧場
ほくせい	北西
ぼくそう	牧草
ぼくたち	僕達
ほくたん	北端
ぼくちく	牧畜
ほくと	北斗
ほくとう	北東
ぼくとう	木刀
ぼくどう	牧童
ぼくとつ	朴訥
ほくぶ	北部
ぼくめつ	撲滅
ほくよう	北洋
ぼくら	僕ら
ぼくら	僕等
ほくりく	北陸
ぼけ	惚け
ほげい	捕鯨
ほけつ	補欠
ぼけつ	墓穴
ほけん	保健
ほけん	保険
ほけんきん	保険金
ほけんしょ	保健所
ほけんふ	保健婦
ほこ	誇
ほご	反古
ほご	反故
ほご	保護
ほご	補語
ぼご	母語
ほこう	歩行
ぼこう	母校
ぼこう	母港
ぼこく	母国
ほこらし	誇らし
ほころ	綻
ほころび	綻び
ほさ	補佐
ほさき	穂先
ほさく	補作
ぼさつ	菩薩
ほし	星
ほし	欲し
ほじ	保持
ぼし	干し
ぼし	母子
ほしが	欲しが
ほしがき	干柿
ほしぞら	星空
ほしゃく	保釈
ほしゅ	保守
ほしゅう	補修
ほしゅう	補習
ほじゅう	補充
ぼしゅう	募集
ぼしゅうだん	母集団
ほしゅは	保守派
ほじょ	補助
ぼしょ	墓所
ほしょう	保証
ほしょう	保障
ほしょう	歩哨
ほしょう	補償
ほしょう	堡礁
ほしょうきん	保証金
ほしょうきん	補償金
ほしょうにん	保証人
ほじょきん	補助金
ほしょく	補色
ほしん	保身
ほせい	補整
ほせい	補正
ぼせい	母性
ほせん	保線
ほぜん	保全
ぼせん	母船
ほそ	細
ほそう	舗装
ほそく	捕捉
ほそく	補則
ほそく	補足
ほそなが	細長
ほそぼそ	細々
ほそめ	細め
ほぞん	保存
ほだい	補題
ぼたい	母体
ぼだい	菩提
ぼたもち	牡丹餅
ほたる	蛍
ぼたん	牡丹
ぼたん	釦
ぼち	墓地
ほちゅう	補注
ほちょう	歩調
ほちょうき	補聴器
ほっ	欲
ぼっ	没
ぼつ	没
ほっき	発起
ぼっき	勃起
ぼっこう	勃興
ぼつこうしょう	没交渉
ぼつこせい	没個性
ぼっこん	墨痕
ほっさ	発作
ぼっしゅう	没収
ほっそく	発足
ほったん	発端
ぼっちゃん	坊っちゃん
ぼっとう	没頭
ぼつにゅう	没入
ぼっぱつ	勃発
ほっぽう	北方
ぼつらく	没落
ほて	火照
ほてん	補填
ほど	解
ほど	程
ほどう	舗道
ほどう	歩道
ほどう	補導
ほどうきょう	歩道橋
ほとけ	仏
ほどこ	施
ほととぎす	不如帰
ほとんど	殆
ほとんど	殆ど
ほとんど	殆んど
ぼにゅう	母乳
ほね	骨
ぼね	骨
ほねお	骨折
ほねぐみ	骨組み
ほねつぎ	骨接ぎ
ほねぶと	骨太
ほねみ	骨身
ほねやすめ	骨休め
ほのお	炎
ほのお	焔
ぼば	牡馬
ほばく	捕縛
ぼひ	墓碑
ほひつ	補弼
ほひつ	補筆
ぼひょう	墓標
ほふ	屠
ほへい	歩兵
ほほ	頬
ほぼ	保母
ほほえ	微笑
ほまれ	誉れ
ほむら	焔
ほめ	褒め
ほめ	誉め
ほゆう	保有
ほよう	保養
ほら	洞
ぼら	鯔
ぼら	鰡
ほり	壕
ほり	濠
ほり	堀
ほりだ	掘り出
ほりゅう	保留
ほりょ	捕虜
ほるい	堡塁
ほれ	惚れ
ぼれい	牡蛎
ほれこ	惚れ込
ほろ	幌
ほろ	滅
ほろび	亡び
ほろび	滅び
ほろぼ	滅ぼ
ほん	本
ぼん	盆
ほんあん	本案
ほんい	本位
ほんい	本意
ぼんおどり	盆踊り
ほんか	本科
ほんかい	本会
ほんかいぎ	本会議
ほんかく	本格
ほんかくは	本格派
ほんかん	本館
ほんがん	本願
ほんき	本気
ほんぎまり	本決まり
ほんきゅう	本給
ほんきょ	本拠
ほんぎょう	本業
ほんきょく	本局
ほんきょち	本拠地
ぼんくれ	盆暮れ
ほんけ	本家
ほんけん	本件
ぼんご	梵語
ほんこう	本校
ほんこう	本稿
ほんごく	本国
ほんごし	本腰
ほんさい	本妻
ぼんさい	凡才
ぼんさい	盆栽
ほんざん	本山
ほんし	本旨
ほんし	本紙
ほんし	本誌
ぼんじ	梵字
ほんしき	本式
ほんしつ	本質
ほんじつ	本日
ほんしゃ	本社
ほんしょ	本署
ほんしょ	本書
ほんしょう	本省
ほんしょう	本章
ほんしょう	本性
ぼんしょう	梵鐘
ほんしょく	本職
ほんしん	本心
ほんじん	本陣
ぼんじん	凡人
ほんすう	本数
ほんすじ	本筋
ほんせき	本籍
ほんせん	本線
ほんせん	本船
ほんせん	本選
ほんそう	奔走
ほんそく	本則
ぼんぞく	凡俗
ほんぞん	本尊
ほんたい	本体
ほんだい	本代
ほんだい	本題
ほんたく	本宅
ほんたて	本立
ほんだな	本棚
ぼんち	盆地
ほんちょう	本庁
ほんてん	本店
ほんど	本土
ほんとう	奔騰
ほんとう	本当
ほんどう	本堂
ほんどう	本道
ほんどおり	本通り
ほんにん	本人
ほんね	本音
ほんねん	本年
ほんのう	本能
ぼんのう	煩悩
ほんば	奔馬
ほんば	本場
ほんばこ	本箱
ほんばん	本番
ほんぶ	本部
ぼんぷ	凡夫
ほんぶん	本文
ほんぺん	本編
ほんぽう	奔放
ほんぽう	本邦
ほんまつてんとう	本末転倒
ほんみょう	本名
ほんむ	本務
ほんめい	本命
ほんもう	本望
ほんもと	本元
ほんもの	本物
ほんや	本屋
ほんやく	翻訳
ぼんよう	凡庸
ほんらい	本来
ほんりゅう	奔流
ほんりゅう	本流
ほんりょう	本領
ほんろう	翻弄
ま	巻
ま	間
ま	捲
ま	撒
ま	蒔
ま	真
ま	増
ま	待
ま	舞
ま	摩
ま	磨
ま	魔
まあい	間合
まあい	間合い
まあじゃん	麻雀
まーじゃん	麻雀
まあたらし	真新し
まい	参
まい	舞
まい	枚
まい	毎
まいあさ	毎朝
まいかい	毎回
まいき	毎期
まいきょ	枚挙
まいこ	舞い込
まいご	迷子
まいじ	毎時
まいしゅう	毎週
まいしん	邁進
まいすう	枚数
まいせつ	埋設
まいそう	埋葬
まいぞう	埋蔵
まいつき	毎月
まいど	毎度
まいとし	毎年
まいにち	毎日
まいねん	毎年
まいばん	毎晩
まいぼつ	埋没
まいまい	毎々
まいよ	毎夜
まうえ	真上
まえ	前
まえあし	前足
まえうり	前売
まえおき	前置き
まえがき	前書き
まえかけ	前掛け
まえがし	前貸し
まえがり	前借り
まえがわ	前側
まえきん	前金
まえのめり	前のめり
まえば	前歯
まえばらい	前払い
まえぶれ	前触れ
まえまえ	前々
まえむき	前向き
まえもって	前もって
まおとこ	間男
まか	任
まか	負か
まか	摩訶
まが	曲
まが	曲が
まが	紛
まかい	魔界
まがお	真顔
まかせ	委せ
まかせ	任せ
まかな	賄
まかふしぎ	摩訶不思議
まがまがし	凶々し
まがり	間借り
まがりかど	曲り角
まき	真木
まき	薪
まき	牧
まきあげ	巻き上げ
まきえ	蒔絵
まきかえし	巻き返し
まきがみ	巻紙
まきこ	巻き込
まきじゃく	巻尺
まきた	真北
まきつ	巻き付
まきつけ	巻き付け
まきば	牧場
まきもの	巻物
まぎら	紛ら
まぎらわし	紛らわし
まぎれ	紛れ
まぎれこ	紛れ込
まぎわ	間際
まく	捲く
まく	幕
まく	膜
まくあけ	幕開け
まくうち	幕内
まくぎれ	幕切れ
まくした	幕下
まくら	枕
まくらぎ	枕木
まぐろ	鮪
まけ	敗け
まけ	負け
まげ	曲げ
まげ	枉げ
まけこ	負け越
まご	孫
まごい	真鯉
まごころ	真心
まこと	真
まこと	誠
まさ	勝
まさ	優
まざ	交ざ
まざ	混ざ
まさき	正木
まさしく	正しく
まさつ	摩擦
まさに	正に
まさめ	正目
まさゆめ	正夢
まじ	交じ
まじ	混じ
まじえ	交え
ました	真下
まじめ	真面目
ましゃく	間尺
まじゅつ	魔術
まじょ	魔女
ましょうめん	真正面
まじわ	交わ
ましん	麻疹
ます	益
ます	升
ます	鱒
まず	先ず
まず	不味
ますい	麻酔
まずし	貧し
ますます	益々
ますめ	升目
ますめ	枡目
まぜ	混ぜ
まぜあわせ	混ぜ合わせ
また	股
また	跨
また	又
まだ	未だ
またが	跨
またぎき	又聞き
またた	瞬
まだら	斑
まち	街
まち	町
まちあ	待ち合
まちあい	待合
まちあいしつ	待合室
まちあわ	待ち合わ
まちが	間違
まぢか	間近
まちかど	街角
まちぢゅう	町中
まちどおし	待ち遠し
まちなか	町中
まちなみ	町並み
まちのぞ	待ち望
まちばり	待ち針
まちばり	待針
まちびと	待ち人
まちびと	待人
まちぶせ	待ち伏せ
まちぶせ	待伏せ
まつ	祭
まつ	松
まつ	奉
まつ	末
まつえい	末裔
まっか	真っ赤
まっき	末期
まっくら	真っ暗
まっくろ	真っ黒
まつげ	睫
まつげ	睫毛
まつご	末期
まっこう	真向
まっこう	抹香
まっさいちゅう	真最中
まっさお	真っ青
まっさき	真っ先
まっさつ	抹殺
まつじつ	末日
まつじめ	末締め
まっしょう	抹消
まっしょう	末梢
まっしろ	真っ白
まっすぐ	真っ直
まっすぐ	真直
まっせ	末世
まっせき	末席
まつだい	末代
まったく	全く
まつたけ	松茸
まったん	末端
まっちゃ	抹茶
まっとう	真っ当
まっとう	全う
まつばづえ	松葉杖
まつばら	松原
まつび	末尾
まっぴつ	末筆
まっぴるま	真っ昼間
まっぷたつ	真っ二つ
まつぼっくり	松ぼっくり
まつやま	松山
まつり	祭
まつりごと	政
まつろ	末路
まつわ	纏わ
まで	迄
まと	的
まど	窓
まど	惑
まとい	纏
まどう	魔道
まどお	間遠
まどがわ	窓側
まどぎわ	窓際
まどぐち	窓口
まどべ	窓辺
まどり	間取り
まどわ	惑わ
まな	学
まないた	俎
まなこ	眼
まなざし	眼差し
まなつ	真夏
まなでし	愛弟子
まなびと	学び取
まにあ	間に合
まにし	真西
まぬがれ	免れ
まぬけ	間抜け
まね	招
まね	真似
まのび	間延び
まばた	瞬
まばたき	瞬き
まばゆ	眩
まばら	疎ら
まび	間引
まひがし	真東
まひる	真昼
まぶか	目深
まぶた	瞼
まふゆ	真冬
まほう	魔法
まほうじん	魔方陣
まぼろし	幻
まま	間々
まま	侭
まま	儘
ままはは	継母
まみず	真水
まみなみ	真南
まみれ	塗れ
まめ	豆
まめきゅう	豆球
まめつ	摩滅
まめつぶ	豆粒
まも	護
まも	守
まもう	摩耗
まもの	魔物
まやく	麻薬
まゆ	眉
まゆ	繭
まゆげ	眉毛
まゆずみ	黛
まゆつば	眉唾
まよ	迷
まよなか	真夜中
まり	鞠
まりょく	魔力
まる	丸
まるき	丸木
まるぞこ	丸底
まるた	丸太
まるだし	丸出し
まるはだか	丸裸
まるまる	丸々
まるめ	丸め
まるめこ	丸め込
まるゆう	マル優
まれ	希
まれ	稀
まろ	麿
まろうど	客人
まろやか	円やか
まわ	回
まわ	廻
まわり	廻り
まわり	周り
まわりこ	回り込
まわりみち	回り道
まん	万
まん	萬
まんいち	万一
まんいん	満員
まんえつ	満悦
まんえん	万円
まんえん	蔓延
まんが	漫画
まんかい	満開
まんがいち	万が一
まんがん	満貫
まんがん	満願
まんかんしょく	満艦飾
まんがんぜんせき	満漢全席
まんき	満期
まんきつ	満喫
まんげきょう	万華鏡
まんげつ	満月
まんさい	満載
まんざい	漫才
まんじ	卍
まんしつ	満室
まんじどもえ	卍巴
まんしゃ	満車
まんじゅう	饅頭
まんじょう	満場
まんしん	慢心
まんしん	満身
まんすい	満水
まんせい	慢性
まんせき	満席
まんぜん	漫然
まんぞく	満足
まんだら	曼荼羅
まんちょう	満潮
まんてん	満点
まんなか	真ん中
まんなか	真中
まんにん	万人
まんねんひつ	万年筆
まんびき	万引き
まんべんな	万遍な
まんめん	満面
まんゆう	漫遊
まんよう	万葉
まんようがな	万葉仮名
まんりょう	満了
み	看
み	観
み	見
み	視
み	実
み	診
み	身
み	満
み	魅
み	巳
みあ	見合
みあげ	見上げ
みあた	見当た
みあわせ	見合わせ
みい	見入
みいだ	見出
みうけ	見受け
みうごき	身動き
みうしな	見失
みうち	身内
みえ	見え
みえ	見栄
みえ	見得
みえかくれ	見えかくれ
みおく	見送
みおさめ	見納め
みおと	見落
みおと	見落と
みおとり	見劣り
みおぼえ	見覚え
みおも	身重
みおろ	見下ろ
みが	研
みが	磨
みかい	未開
みかいけつ	未解決
みかえ	見返
みかえり	見返り
みかぎ	見限
みかく	味覚
みかくてい	未確定
みかくにん	未確認
みかけ	見かけ
みかけ	見掛け
みかた	見方
みかた	味方
みかづき	三日月
みがって	身勝手
みかど	帝
みかね	見兼ね
みがまえ	身構え
みがら	身柄
みがる	身軽
みかわ	見交わ
みがわり	身代り
みかん	未刊
みかん	未完
みかん	蜜柑
みかんせい	未完成
みき	幹
みき	見切
みぎ	右
みぎあし	右足
みぎうえ	右上
みぎうで	右腕
みぎがわ	右側
みきき	見聞き
みぎした	右下
みぎて	右手
みぎはし	右端
みぎめ	右目
みきり	見切り
みぎわ	汀
みきわめ	見極め
みくだ	見下
みくだりはん	三下り半
みくび	見くび
みくび	見縊
みくらべ	見比べ
みぐるし	見苦し
みけ	三毛
みけつ	未決
みけん	眉間
みこ	見越
みこ	見込
みこ	御子
みこし	御輿
みごたえ	見ごたえ
みごたえ	見応え
みこと	尊
みごと	見事
みことのり	詔
みことのり	勅
みごろし	見殺し
みこん	未婚
みさい	未済
みさお	操
みさかい	見境
みさき	崎
みさき	岬
みさげ	見下げ
みさだめ	見定め
みし	見知
みじか	短
みじたく	身支度
みじめ	惨め
みしゅう	未収
みじゅく	未熟
みしよう	未使用
みじん	微塵
みず	水
みず	瑞
みずあび	水浴び
みずあらい	水洗い
みすい	未遂
みずいらず	水入らず
みずいろ	水色
みずうみ	湖
みすえ	見据え
みずかき	水掻き
みずかさ	水かさ
みずから	自ら
みずぎ	水着
みずぎわ	水際
みずけ	水気
みすご	見過ご
みずたま	水玉
みすて	見捨て
みずどけい	水時計
みずどり	水鳥
みずのえ	壬
みずのと	癸
みずはけ	水捌け
みずひき	水引
みずびたし	水浸し
みずぶそく	水不足
みずべ	水辺
みずほ	瑞穂
みずまし	水増し
みずむし	水虫
みせ	見せ
みせ	店
みせいねん	未成年
みせかけ	見せかけ
みせさき	店先
みせじまい	店仕舞い
みせつけ	見せつけ
みせばん	店番
みせもの	見せ物
みぜん	未然
みぜんけい	未然形
みそ	晦
みそ	味噌
みぞ	渠
みぞ	溝
みぞう	未曽有
みそか	晦日
みそぎ	禊
みそこな	見損な
みそじ	三十路
みそに	味噌煮
みそめ	見初め
みそら	身空
みた	充た
みた	満た
みだ	見出
みだ	乱
みたけ	身丈
みだし	見出し
みだしなみ	身だしなみ
みたて	見立て
みだら	淫ら
みだれ	乱れ
みち	盈ち
みち	途
みち	道
みち	満ち
みち	未知
みち	路
みぢか	身近
みちがえ	見違え
みちしお	満ち潮
みちじゅん	道順
みちしるべ	道標
みちすじ	道筋
みちづれ	道連れ
みちのり	道のり
みちばた	道端
みちび	導
みちびきだ	導き出
みちゃく	未着
みつ	貢
みつ	密
みつ	蜜
みっか	3日
みっか	３日
みっか	三日
みつか	見つか
みつか	見付か
みっかい	密会
みっきょう	密教
みつくろ	見繕
みつけ	見つけ
みつけ	見付け
みつけだ	見つけ出
みっこう	密航
みっこく	密告
みっし	密使
みっしつ	密室
みっしゅう	密集
みっせつ	密接
みっそう	密葬
みつぞう	密造
みつぞろえ	三つ揃え
みつだん	密談
みっちゃく	密着
みっつ	三つ
みってい	密偵
みつど	密度
みつどもえ	三つ巴
みつにゅうこく	密入国
みつばい	密売
みつばち	蜜蜂
みっぷう	密封
みっぺい	密閉
みつめ	見つめ
みつも	見積も
みつもり	見積り
みつもりしょ	見積書
みつゆ	密輸
みつりょう	密漁
みつりょう	密猟
みつりん	密林
みてい	未定
みていぎ	未定義
みと	看取
みと	見取
みとう	未踏
みどう	御堂
みとうさ	未踏査
みとお	見通
みとおし	見通し
みどく	未読
みどころ	見所
みどし	巳年
みとどけ	見届け
みとめ	認め
みとめいん	認印
みどり	緑
みとりず	見取図
みな	皆
みな	見な
みな	見做
みなお	見直
みなさま	皆様
みなさん	皆さん
みなづき	水無月
みなと	港
みなと	湊
みなみ	南
みなみがわ	南側
みなみじゅうじせい	南十字星
みなみまわり	南回り
みなも	水面
みなもと	源
みなら	見習
みなら	見倣
みなり	身なり
みなれ	見なれ
みなれ	見慣れ
みにく	見にく
みにく	醜
みぬ	見抜
みね	峰
みね	嶺
みの	実
みの	蓑
みの	稔
みのう	未納
みのうえ	身の上
みのが	見逃
みのまわり	身の回り
みは	見張
みは	瞠
みばえ	見栄え
みはから	見計ら
みはな	見放
みはら	見晴ら
みはらい	未払い
みひつ	未必
みひら	見開
みぶり	見ぶり
みぶり	身振り
みぶるい	身震い
みぶん	身分
みぼうじん	未亡人
みほん	見本
みまい	見舞
みまい	見舞い
みまいきん	見舞金
みまが	見紛
みまがえ	見紛え
みまね	見まね
みまも	見守
みまわ	見回
みまん	未満
みみ	耳
みみうち	耳打ち
みみがくもん	耳学問
みみざわり	耳障り
みみどしま	耳年増
みみより	耳寄り
みむ	見向
みめい	未明
みもだえ	身悶え
みもと	身元
みもん	未聞
みや	宮
みゃく	脈
みゃくどう	脈動
みゃくはく	脈拍
みゃくらく	脈絡
みやげ	土産
みやげばなし	土産話
みやこ	都
みやぶ	見破
みやま	深山
みょう	妙
みょうあん	妙案
みょうが	冥加
みょうが	茗荷
みょうぎ	妙技
みょうごにち	明後日
みょうじ	苗字
みょうじ	名字
みょうしゅ	妙手
みょうじょう	明星
みょうだい	名代
みょうちょう	明朝
みょうにち	明日
みょうねん	明年
みょうばん	明晩
みょうばん	明礬
みょうり	冥利
みより	身寄り
みらい	未来
みりょう	未了
みりょう	魅了
みりょく	魅力
みりん	味醂
みるからに	見るからに
みれん	未練
みわく	魅惑
みわけ	見分け
みわた	見渡
みんい	民意
みんえい	民営
みんか	民家
みんかん	民間
みんげい	民芸
みんけん	民権
みんじ	民事
みんしゅ	民主
みんじゅ	民需
みんしゅう	民衆
みんしゅく	民宿
みんせい	民政
みんせい	民生
みんぞく	民俗
みんぞく	民族
みんな	皆
みんぽう	民放
みんぽう	民法
みんゆう	民有
みんよう	民謡
みんわ	民話
む	向
む	蒸
む	剥
む	無
む	六
むい	無為
むいか	6日
むいか	６日
むいか	六日
むいちぶつ	無一物
むいちもん	無一文
むいみ	無意味
むえき	無益
むえん	無縁
むえん	無鉛
むおん	無音
むか	向か
むが	無我
むがい	無害
むかいあ	向かい合
むかえ	迎え
むかえいれ	迎え入れ
むがく	無学
むかし	昔
むかしばなし	昔話
むかしむかし	昔々
むかっぱら	むかっ腹
むかん	無冠
むき	無期
むき	無機
むぎ	麦
むきあ	向き合
むきず	無傷
むきだ	むき出
むぎちゃ	麦茶
むきどう	無軌道
むぎばたけ	麦畑
むきゅう	無休
むきゅう	無給
むきりょく	無気力
むぎわら	麦ワラ
むぎわら	麦藁
むく	浮腫
むく	無垢
むく	椋
むくい	報い
むくち	無口
むくどり	椋鳥
むくろ	骸
むくろ	躯
むけ	向け
むげ	無碍
むけい	無形
むげい	無芸
むけつ	無欠
むげん	無限
むげんえん	無限遠
むげんだい	無限大
むこ	婿
むご	酷
むご	惨
むこう	向う
むこう	向こう
むこう	無効
むこん	無根
むごん	無言
むざい	無罪
むさし	武蔵
むさぼ	貪
むさん	無産
むざん	無惨
むざん	無残
むし	虫
むし	無視
むじ	無地
むしあつ	蒸し暑
むしかえ	蒸し返
むしけら	虫けら
むじつ	無実
むじな	貉
むしば	蝕
むしば	虫歯
むしゃ	武者
むじゃき	無邪気
むしゃぶるい	武者震い
むしゅう	無臭
むじゅん	矛盾
むしょう	無償
むしょう	無性
むしょう	霧消
むじょう	無常
むじょう	無情
むじょうかん	無常観
むじょうけん	無条件
むしょく	無職
むしょく	無色
むしろ	筵
むしろ	蓆
むしん	無心
むじん	無人
むじん	無尽
むしんろん	無神論
むす	結
むすう	無数
むずかし	難し
むすこ	息子
むすびつ	結びつ
むすびつ	結び付
むすびつけ	結びつけ
むすめ	娘
むせ	咽
むせい	無声
むぜい	無税
むせきにん	無責任
むせっそう	無節操
むせん	無線
むせん	無銭
むせんき	無線機
むそう	夢想
むぞうさ	無造作
むそじ	六十路
むだ	無駄
むだん	無断
むち	鞭
むち	無知
むちゃ	無茶
むちゃくちゃ	無茶苦茶
むちゅう	夢中
むちん	無賃
むつう	無痛
むつかし	難し
むつき	睦月
むっつ	六つ
むつまじ	睦まじ
むてき	無敵
むてじゅん	無手順
むてっぽう	無鉄砲
むでん	無電
むどく	無毒
むとんちゃく	無頓着
むなげ	胸毛
むなさわぎ	胸騒ぎ
むなし	虚し
むなし	空し
むに	無二
むね	胸
むね	旨
むね	棟
むねあげ	棟上げ
むねん	無念
むねんむそう	無念無想
むのう	無能
むはい	無敗
むひ	無比
むびょう	無病
むひょうじょう	無表情
むふう	無風
むへんかん	無変換
むほう	無法
むぼう	無謀
むぼうび	無防備
むま	夢魔
むみ	無味
むめい	無名
むめい	無銘
むやみ	無闇
むゆうびょう	夢遊病
むよう	無用
むよく	無欲
むら	蒸ら
むら	村
むらが	群が
むらさき	紫
むらはちぶ	村八分
むり	無理
むりじい	無理強い
むりやり	無理矢理
むりょう	無料
むりょう	無量
むりょく	無力
むるい	無類
むれ	群
むれ	群れ
むれ	蒸れ
むろ	室
むろまち	室町
むろん	無論
むろんの	無論の
め	芽
め	眼
め	召
め	目
めあたらし	目新し
めあて	目当て
めい	名
めい	命
めい	銘
めい	姪
めい	滅入
めい	暝
めいあん	名案
めいあん	明暗
めいい	名医
めいう	銘打
めいうん	命運
めいか	名家
めいか	銘菓
めいが	名画
めいかい	明解
めいかい	明快
めいかく	明確
めいがら	銘柄
めいき	明記
めいき	銘記
めいぎ	名義
めいきゅう	迷宮
めいきょく	名曲
めいげつ	名月
めいけん	名剣
めいけん	名犬
めいげん	名言
めいげん	明言
めいこう	名工
めいさい	明細
めいさい	迷彩
めいさく	名作
めいさつ	名刹
めいさん	名産
めいし	名刺
めいし	名詞
めいじ	明示
めいじつ	名実
めいしゅ	名手
めいしゅ	銘酒
めいしょ	名所
めいしょう	名勝
めいしょう	名称
めいしょく	明色
めいしん	迷信
めいじん	名人
めいすい	名水
めいすう	名数
めいせい	名声
めいせき	明晰
めいせん	名泉
めいそう	瞑想
めいだい	命題
めいち	明知
めいちゅう	命中
めいちょ	名著
めいっぱい	目一杯
めいど	冥土
めいど	明度
めいとう	名刀
めいとう	名答
めいにち	命日
めいば	名馬
めいはく	明白
めいび	明媚
めいびん	明敏
めいふ	冥府
めいふく	冥福
めいぶつ	名物
めいぶん	名分
めいぶん	名文
めいぶんか	明文化
めいぼ	名簿
めいほう	盟邦
めいぼう	名望
めいぼく	銘木
めいめい	命名
めいめい	銘々
めいめいはくはく	明々白々
めいもく	名目
めいもく	暝黙
めいもん	名門
めいよ	名誉
めいりょう	明瞭
めいれい	命令
めいろ	迷路
めいろう	明朗
めいわく	迷惑
めうえ	目上
めうし	牝牛
めうつり	目移り
めおと	夫婦
めかけ	妾
めがしら	目頭
めかた	目方
めがね	眼鏡
めがみ	女神
めぐ	恵
めぐ	巡
めぐすり	目薬
めくら	盲
めぐりあ	巡り合
めくるめく	目くるめく
めざ	目指
めさき	目先
めざと	目ざと
めざまし	目覚し
めざめ	目覚め
めざわり	目障り
めし	飯
めした	目下
めしつかい	召使
めじり	目尻
めじるし	目印
めじろ	繍眼児
めじろ	目白
めす	雌
めす	牝
めずらし	珍し
めせん	目線
めだ	目立
めだま	目玉
めちゃくちゃ	滅茶苦茶
めつ	滅
めっき	滅金
めっきゃく	滅却
めっきん	滅菌
めっしつ	滅失
めった	滅多
めったに	滅多に
めつぼう	滅亡
めっぽう	滅法
めど	目処
めのう	碼碯
めばえ	芽生え
めはな	目鼻
めぶんりょう	目分量
めべり	目減り
めぼし	目星
めまぐるし	目まぐるし
めめし	女々し
めもちょう	メモ帳
めもと	目元
めもり	目盛
めもり	目盛り
めやす	目安
めやに	目脂
めりけんこ	メリケン粉
めん	免
めん	綿
めん	面
めん	麺
めんえき	免疫
めんか	棉花
めんかい	面会
めんきょ	免許
めんきょかいでん	免許皆伝
めんきょしょう	免許証
めんざい	免罪
めんし	綿糸
めんしき	面識
めんじょ	免除
めんじょう	免状
めんしょく	免職
めんぜい	免税
めんせき	免責
めんせき	面積
めんせつ	面接
めんぜん	面前
めんそ	免租
めんそ	免訴
めんそう	面相
めんたいこ	明太子
めんだん	面談
めんつ	面子
めんどう	面倒
めんぼく	面目
めんみつ	綿密
めんめん	面々
めんもく	面目
めんるい	麺類
も	洩
も	持
も	盛
も	喪
も	藻
も	燃
も	模
も	漏
も	揉
もう	申
もうい	猛威
もうか	儲か
もうきん	猛禽
もうけ	設け
もうけ	儲け
もうげん	妄言
もうさいかん	毛細管
もうしあげ	申し上げ
もうしあわ	申し合わ
もうしいれ	申し入れ
もうしうけ	申し受け
もうしこ	申し込
もうしご	申し子
もうしこみ	申込
もうしこみしょ	申込書
もうしたてしょ	申立書
もうしつけ	申しつけ
もうしで	申し出
もうしぶん	申し分
もうじゃ	亡者
もうしゅう	妄執
もうじゅう	猛獣
もうしょ	猛暑
もうしわけ	申し訳
もうしわけな	申し訳な
もうしわた	申し渡
もうしん	盲信
もうじん	盲人
もうせん	毛氈
もうぜん	猛然
もうそう	妄想
もうそうちく	孟宗竹
もうちょう	盲腸
もうで	詣で
もうてん	盲点
もうとう	毛頭
もうどうけん	盲導犬
もうどく	猛毒
もうはつ	毛髪
もうひつ	毛筆
もうふ	毛布
もうぼさんせん	孟母三遷
もうまい	蒙昧
もうまく	網膜
もうもく	盲目
もうら	網羅
もうれつ	猛烈
もえ	燃え
もえ	萌
もえ	萌え
もぎ	模擬
もく	黙
もく	目
もぐ	潜
もくあみ	黙阿弥
もくげき	目撃
もくざい	木材
もくさつ	黙殺
もくさん	目算
もくし	黙視
もくし	目指
もくし	目視
もくじ	目次
もくぜん	目前
もくぞう	木造
もくそく	目測
もくたん	木炭
もくてき	目的
もくてきち	目的地
もくとう	黙祷
もくにん	黙認
もくば	木馬
もくひ	黙秘
もくひょう	目標
もくめ	木目
もくもく	黙々
もくよう	木曜
もくようび	木曜日
もぐりこ	もぐり込
もくれい	黙礼
もくろ	目論
もくろく	目録
もくろみ	目論見
もけい	模型
もさ	猛者
もさく	模索
もじ	文字
もしき	模式
もじしゅ	文字種
もじすう	文字数
もじばけ	文字化け
もしゃ	模写
もしゅ	喪主
もしょう	喪章
もず	百舌
もず	鵙
もぞう	模造
もだえ	悶え
もち	持ち
もち	餅
もちあが	持ち上が
もちあげ	持ち上げ
もちある	持ち歩
もちあわ	持ち合わ
もちい	用い
もちかけ	持ち掛け
もちこ	持ち越
もちこ	持ち込
もちごめ	餅米
もちさ	持ち去
もちだ	持ち出
もちづき	望月
もちなお	持ち直
もちはこ	持ち運
もちはだ	餅肌
もちまわ	持ち回
もちゅう	喪中
もちよ	持ち寄
もちろん	勿論
もちろんの	勿論の
もっこう	木瓜
もっこう	木工
もったい	勿体
もって	以って
もって	以て
もっとも	最も
もっとも	尤も
もっぱら	専ら
もつやく	没薬
もてあそ	弄
もてあま	持て余
もでるか	モデル化
もと	下
もと	基
もと	求
もと	元
もと	素
もど	戻
もとい	基
もとうけ	元請け
もとき	本木
もとじめ	元締め
もとせん	元栓
もとちょう	元帳
もとづ	基づ
もとで	元手
もとどおり	元通り
もとね	元値
もとま	求ま
もとむ	求む
もとめ	求め
もともと	元々
もの	者
もの	物
ものおき	物置
ものおと	物音
ものおもい	物思い
ものかき	物書き
ものがたり	物語
ものがなし	もの悲し
ものがなし	物悲し
ものごい	物乞い
ものごと	物事
ものさし	物差し
ものしずか	物静か
ものしり	物知り
ものずき	物好き
ものすご	物凄
ものたりな	物足りな
ものほし	物干し
ものめずらし	物珍し
もはや	最早
もはん	模範
もふく	喪服
もほう	模倣
もみけ	もみ消
もみけ	揉み消
もみじ	椛
もみじ	紅葉
もめ	揉め
もめごと	揉め事
もめん	木綿
もも	股
もも	腿
もも	桃
もや	燃や
もや	母屋
もや	靄
もやし	萌やし
もよう	模様
もよお	催
もより	最寄り
もら	貰
もら	漏ら
もり	守
もり	森
もり	杜
もりあが	盛り上が
もりあげ	盛り上げ
もりかえ	盛りかえ
もりこ	盛り込
もりたて	守り立て
もりたて	盛り立て
もれ	洩れ
もろ	諸
もろ	脆
もろもろ	諸々
もん	紋
もん	門
もんか	門下
もんがい	門外
もんがいかん	門外漢
もんきりがた	紋切り型
もんく	文句
もんげん	門限
もんこ	門戸
もんし	悶死
もんし	門歯
もんしょう	紋章
もんしん	問診
もんぜん	門前
もんぜんばらい	門前払い
もんだい	問題
もんだいてん	問題点
もんちゃく	悶着
もんつき	紋付
もんてい	門弟
もんとう	門灯
もんどう	問答
もんどころ	紋所
もんどりう	もんどり打
もんばつ	門閥
もんばん	門番
もんぴ	門扉
もんぴょう	門標
もんぶ	文部
もんめ	匁
もんよう	文様
や	屋
や	遣
や	殺
や	焼
や	妬
や	病
や	野
や	矢
やいば	刃
やえ	八重
やえい	野営
やえば	八重歯
やおちょう	八百長
やおもて	矢面
やおや	八百屋
やがい	野外
やがく	夜学
やかた	屋形
やかた	館
やかた	舘
やかまし	喧し
やから	輩
やかん	夜間
やぎ	山羊
やぎ	夜着
やきいも	焼き芋
やきつ	焼き付
やきつけ	焼付け
やきにく	焼肉
やきもの	焼物
やきゅう	野球
やきん	冶金
やきん	夜勤
やく	厄
やく	役
やく	約
やく	薬
やく	訳
やくいん	役員
やくがい	薬害
やくがく	薬学
やくがくぶ	薬学部
やくがら	役柄
やくご	訳語
やくざい	薬剤
やくしゃ	役者
やくしゃ	訳者
やくしゅつ	訳出
やくしょ	役所
やくじょ	躍如
やくじょう	約定
やくしょく	役職
やくしん	躍進
やくすう	約数
やくそう	薬草
やくそく	約束
やくだ	役立
やくどう	躍動
やくとく	役得
やくどく	役得
やくどく	訳読
やくどし	厄年
やくにん	役人
やくば	役場
やくひん	薬品
やくぶつ	薬物
やくぶん	約分
やくぶん	訳文
やくほうし	薬包紙
やくまん	役満
やくめ	役目
やくよう	薬用
やぐら	櫓
やくわり	役割
やけ	灼け
やけ	焼け
やけい	夜景
やけい	夜警
やけつ	焼け付
やけど	火傷
やけぼっくい	焼けぼっくい
やけぼっくい	焼け棒杭
やこう	夜光
やこう	夜行
やごう	屋号
やさい	野菜
やさき	矢先
やさし	易し
やさし	優し
やし	香具師
やし	椰子
やじ	野次
やじうま	野次馬
やしき	屋敷
やしな	養
やしゅ	野手
やじゅう	野獣
やしょく	夜食
やじるし	矢印
やしろ	社
やしん	野心
やじん	野人
やす	安
やす	易
やす	休
やすあがり	安上がり
やすうり	安売り
やすっぽ	安っぽ
やすね	安値
やすぶしん	安普請
やすま	休ま
やすみ	休み
やすもの	安物
やすら	安ら
やすらか	安らか
やすん	安ん
やせ	痩せ
やせい	野性
やせい	野生
やせおとろえ	やせ衰え
やせほそ	やせ細
やせん	夜戦
やそう	野草
やそうきょく	夜想曲
やそじ	八十路
やたい	屋台
やちよ	八千代
やちょう	野鳥
やちん	家賃
やつ	奴
やつ	八
やっか	薬価
やっかい	厄介
やっかん	約款
やっき	躍起
やっきょう	薬莢
やっきょく	薬局
やっこ	奴
やっつ	八つ
やつめうなぎ	鱧
やつら	奴ら
やど	宿
やとい	雇
やといぬし	雇主
やとう	野党
やとう	野盗
やどや	宿屋
やな	梁
やなぎ	柳
やなぎば	柳刃
やに	脂
やにさが	やに下が
やぬし	家主
やね	屋根
やはん	夜半
やばん	野蛮
やひ	野卑
やぶ	破
やぶ	薮
やぶからぼう	薮から棒
やぶへび	薮蛇
やぶれ	敗れ
やぶれかぶれ	破れかぶれ
やぶれさ	敗れ去
やぶれめ	破れ目
やぶん	夜分
やぼ	野暮
やぼう	野望
やま	山
やまあい	山間
やまい	病
やまおく	山奥
やまがら	山雀
やまかわ	山川
やまがわ	山側
やまくずれ	山崩れ
やまぐに	山国
やまごや	山小屋
やまざくら	山桜
やまざと	山里
やまし	山師
やまし	疚し
やますそ	山裾
やまづみ	山積み
やまて	山手
やまと	大和
やまのて	山の手
やまのぼり	山登り
やまば	山場
やまはだ	山肌
やまもり	山盛り
やまやま	山々
やまわけ	山分け
やみ	闇
やみうち	闇討ち
やみつき	病み付き
やむちゃ	飲茶
やむをえ	やむを得
やむをえず	やむを得ず
やむをえな	やむを得な
やめ	止め
やめ	辞め
やゆ	揶揄
やゆ	椰揄
やよい	弥生
やらい	夜来
やり	槍
やり	鑓
やりすご	やり過ご
やりだま	やり玉
やりて	やり手
やりとり	やり取り
やりなお	やり直
やろう	野郎
やろうじだい	夜郎自大
やわはだ	柔肌
やわら	和ら
やわらか	柔らか
やわらか	軟らか
やんぐりつ	ヤング率
ゆ	往
ゆ	結
ゆ	行
ゆ	逝
ゆ	湯
ゆ	揺
ゆあつ	油圧
ゆいいつ	唯一
ゆいがどくそん	唯我独尊
ゆいごん	遺言
ゆいしょ	由緒
ゆいのう	結納
ゆいぶつ	唯物
ゆう	優
ゆう	有
ゆう	夕
ゆうい	優位
ゆうい	有意
ゆういぎ	有意義
ゆういん	誘引
ゆううつ	憂鬱
ゆうえい	遊泳
ゆうえい	游泳
ゆうえき	有益
ゆうえつ	優越
ゆうえんち	遊園地
ゆうか	有価
ゆうが	優雅
ゆうかい	誘拐
ゆうかい	融解
ゆうがい	有害
ゆうがく	遊学
ゆうがた	夕方
ゆうがとう	誘蛾灯
ゆうかん	勇敢
ゆうかん	夕刊
ゆうき	勇気
ゆうき	有機
ゆうきゅう	悠久
ゆうきゅう	有休
ゆうきゅう	有給
ゆうきゅう	遊休
ゆうぐう	優遇
ゆうぐれ	夕暮れ
ゆうげ	夕餉
ゆうけい	有形
ゆうげん	有限
ゆうげんがいしゃ	有限会社
ゆうけんしゃ	有権者
ゆうげんようそほう	有限要素法
ゆうこう	友好
ゆうこう	有効
ゆうごう	融合
ゆうこく	夕刻
ゆうこん	雄渾
ゆうざい	有罪
ゆうし	有志
ゆうし	融資
ゆうしかい	有視界
ゆうしきしゃ	有識者
ゆうしてっせん	有刺鉄線
ゆうしゅう	優秀
ゆうしゅう	憂愁
ゆうじゅうふだん	優柔不断
ゆうしゅつ	湧出
ゆうしゅん	優駿
ゆうじょ	宥恕
ゆうじょ	遊女
ゆうしょう	優勝
ゆうしょう	有償
ゆうじょう	友情
ゆうしょく	夕食
ゆうじん	友人
ゆうじん	有人
ゆうしんろん	有神論
ゆうすい	湧水
ゆうすいち	遊水池
ゆうすう	有数
ゆうずう	融通
ゆうずうむげ	融通無碍
ゆうすずみ	夕涼み
ゆうせい	優勢
ゆうせい	優性
ゆうせい	優生
ゆうせい	有性
ゆうせい	遊星
ゆうぜい	有税
ゆうぜい	遊説
ゆうせつ	融雪
ゆうせん	優先
ゆうせん	有線
ゆうせん	郵船
ゆうぜん	友禅
ゆうぜん	悠然
ゆうそう	郵送
ゆうそう	雄壮
ゆうそくこじつ	有職故実
ゆうたい	優待
ゆうだい	雄大
ゆうだち	夕立ち
ゆうだん	勇断
ゆうち	誘致
ゆうちょ	郵貯
ゆうちょう	悠長
ゆうづう	融通
ゆうとう	優等
ゆうどう	誘導
ゆうどく	有毒
ゆうのう	有能
ゆうはつ	誘発
ゆうはん	夕飯
ゆうひ	夕日
ゆうひ	夕陽
ゆうび	優美
ゆうびん	郵便
ゆうびんきょく	郵便局
ゆうびんぶつ	郵便物
ゆうふく	裕福
ゆうべ	昨夜
ゆうべ	夕べ
ゆうべん	雄弁
ゆうほう	友朋
ゆうぼう	有望
ゆうぼく	遊牧
ゆうほどう	遊歩道
ゆうみん	遊民
ゆうめい	有名
ゆうめし	夕飯
ゆうやく	勇躍
ゆうやく	釉薬
ゆうやけ	夕焼け
ゆうやみ	夕闇
ゆうゆう	悠々
ゆうゆうじてき	悠々自適
ゆうよ	有余
ゆうよ	猶予
ゆうよう	悠揚
ゆうよう	有用
ゆうよく	游弋
ゆうらん	遊覧
ゆうり	有利
ゆうり	有理
ゆうり	遊離
ゆうりすう	有理数
ゆうりょ	憂慮
ゆうりょう	優良
ゆうりょう	有料
ゆうりょく	有力
ゆうれい	幽霊
ゆうれつ	優劣
ゆうわ	宥和
ゆうわ	融和
ゆうわく	誘惑
ゆえ	結え
ゆえ	故
ゆか	床
ゆか	由佳
ゆが	湯が
ゆが	歪
ゆかい	愉快
ゆかうえ	床上
ゆかした	床下
ゆかた	浴衣
ゆかん	湯潅
ゆき	幸
ゆき	雪
ゆきか	行き交
ゆきき	行き来
ゆきぐに	雪国
ゆきげしょう	雪化粧
ゆきどけ	雪解け
ゆきとど	行き届
ゆきみ	雪見
ゆくえ	行方
ゆげ	湯気
ゆけつ	輸血
ゆさぶ	揺さぶ
ゆざまし	湯冷まし
ゆし	油脂
ゆしゅつ	輸出
ゆしゅつにゅう	輸出入
ゆす	濯
ゆず	譲
ゆず	柚
ゆずりあ	譲り合
ゆせい	油井
ゆせい	油性
ゆそう	輸送
ゆたか	豊
ゆたか	豊か
ゆだね	委ね
ゆだん	油断
ゆたんぽ	湯たんぽ
ゆちゃく	癒着
ゆで	茹で
ゆでん	油田
ゆどうふ	湯豆腐
ゆにゅう	輸入
ゆのみ	湯飲み
ゆび	指
ゆびさ	指さ
ゆびさき	指先
ゆびわ	指輪
ゆぶね	湯舟
ゆまく	油膜
ゆみ	弓
ゆめ	夢
ゆめみ	夢見
ゆよく	湯浴
ゆら	揺ら
ゆらい	由来
ゆり	百合
ゆる	緩
ゆる	許
ゆる	揺る
ゆるめ	緩め
ゆるやか	緩やか
ゆれ	揺れ
ゆわえ	結わえ
ゆわかし	湯沸し
よ	依
よ	因
よ	詠
よ	佳
よ	寄
よ	呼
よ	好
よ	止
よ	酔
よ	世
よ	選
よ	善
よ	代
よ	読
よ	撚
よ	夜
よ	余
よ	良
よ	縒
よあけ	夜明け
よい	宵
よいっぱり	宵っ張り
よいん	余韻
よう	擁
よう	楊
よう	様
よう	洋
よう	用
よう	要
よう	陽
ようい	容易
ようい	用意
よういおん	陽イオン
よういく	養育
よういん	要員
よういん	要因
ようえき	溶液
ようおん	拗音
ようか	8日
ようか	８日
ようか	八日
ようが	洋画
ようが	陽画
ようかい	妖怪
ようかい	容喙
ようかい	溶解
ようかい	熔解
ようがく	洋楽
ようがし	洋菓子
ようかん	洋館
ようかん	羊羹
ようき	容器
ようき	陽気
ようぎ	容疑
ようきゅう	要求
ようぎょう	窯業
ようきょく	謡曲
ようきょく	陽極
ようぎん	洋銀
ようぐ	用具
ようけい	養鶏
ようげき	邀撃
ようけん	用件
ようけん	要件
ようげん	用言
ようご	擁護
ようご	用語
ようご	養護
ようこう	洋行
ようこう	要項
ようこう	陽光
ようこうろ	溶鉱炉
ようさい	洋裁
ようさい	要塞
ようさん	養蚕
ようし	容姿
ようし	用紙
ようし	要旨
ようし	陽子
ようし	養子
ようじ	幼児
ようじ	用事
ようしき	様式
ようしき	洋式
ようしつ	洋室
ようしゃ	容赦
ようしゃな	容赦な
ようしゅ	洋酒
ようじゅつ	妖術
ようしゅん	陽春
ようしょ	洋書
ようしょ	要所
ようじょ	幼女
ようじょ	養女
ようしょう	幼少
ようしょう	要衝
ようじょう	洋上
ようじょう	養生
ようしょく	容色
ようしょく	洋食
ようしょく	要職
ようしょく	養殖
ようじん	用心
ようじん	要人
ようす	様子
ようすい	用水
ようせい	妖精
ようせい	要請
ようせい	陽性
ようせい	養成
ようせい	夭逝
ようせき	容積
ようせつ	溶接
ようせつ	熔接
ようせつ	夭折
ようせん	用箋
ようそ	要素
ようそう	様相
ようだい	容体
ようち	幼稚
ようち	用地
ようちあさがけ	夜討ち朝駆け
ようちえん	幼稚園
ようちゅう	幼虫
ようちょう	羊腸
ようてい	要諦
ようてん	要点
ようでんし	陽電子
ようと	用途
ようと	杳と
ようど	用度
ようとん	養豚
ようにん	容認
ようねん	幼年
ようび	曜日
ようひし	羊皮紙
ようひん	洋品
ようふ	養父
ようふう	洋風
ようふく	洋服
ようふぼ	養父母
ようぶん	養分
ようへい	用兵
ようほう	用法
ようぼう	容貌
ようぼう	要望
ようま	洋間
ようむ	用務
ようめい	用命
ようもう	羊毛
ようもの	洋物
ようやく	要約
ようゆう	熔融
ようよう	洋々
ようらん	要覧
ようらんき	揺籃期
ようりく	揚陸
ようりょう	容量
ようりょう	要領
ようりょく	揚力
ようりょくそ	葉緑素
ようりょくたい	葉緑体
ようれい	用例
ようれき	陽暦
ようろう	養老
ようろく	要録
よか	予価
よか	余暇
よかく	与格
よかん	予感
よき	予期
よぎな	余儀な
よきょう	余興
よきん	預金
よく	慾
よく	欲
よく	浴
よく	良く
よくあつ	抑圧
よくげつ	翌月
よくし	抑止
よくしつ	浴室
よくじつ	翌日
よくしゅう	翌週
よくじょう	浴場
よくせい	抑制
よくそう	浴槽
よくたん	翼端
よくちょう	翌朝
よくど	沃土
よくとく	欲得
よくとし	翌年
よくねん	翌年
よくば	欲張
よくぼう	欲望
よくめんかじゅう	翼面荷重
よくよう	抑揚
よくよう	浴用
よくよくじつ	翌々日
よくりゅう	抑留
よけ	避け
よけい	余計
よげん	予言
よげん	余弦
よげん	預言
よこ	横
よご	汚
よご	予後
よこう	予稿
よこう	予行
よこがお	横顔
よこぎ	横切
よこく	予告
よこざま	横様
よこしま	邪
よこじま	横縞
よこたわ	横たわ
よこづな	横綱
よこて	横手
よこどり	横取り
よこなが	横長
よこばい	横ばい
よこみち	横道
よこめ	横目
よごれ	汚れ
よこれんぼ	横恋慕
よさそう	良さそう
よさん	予算
よし	葦
よし	好
よし	由
よしあし	善し悪し
よしゅう	予習
よじょう	余剰
よじょう	余情
よしん	余震
よじん	余人
よせ	寄せ
よせ	寄席
よせい	余生
よせがき	寄書き
よせん	予選
よせん	予餞
よそう	予想
よそうがい	予想外
よそお	装
よそく	予測
よそじ	四十路
よぞら	夜空
よたく	預託
よだん	予断
よだん	余談
よち	予知
よち	余地
よちょう	予兆
よちょきん	預貯金
よっか	4日
よっか	４日
よっか	四日
よつかど	四つ角
よつぎ	世継
よっきゅう	欲求
よっつ	四つ
よっぱら	酔っ払
よてい	予定
よど	淀
よとう	与党
よなか	夜中
よねつ	余熱
よねん	余念
よのなか	世の中
よは	余波
よばい	夜這い
よはく	余白
よび	予備
よびかけ	呼びかけ
よびかけ	呼掛け
よびぐん	予備軍
よびこ	呼び込
よびこう	予備校
よびごえ	呼び声
よびだ	呼び出
よびだし	呼出
よびだし	呼出し
よびもど	呼び戻
よびよせ	呼び寄せ
よふかし	夜更し
よふけ	夜更け
よぶん	余分
よほう	予報
よぼう	予防
よまいごと	世迷い言
よみあげ	読み上げ
よみがえ	蘇
よみがえ	甦
よみかき	読み書き
よみかた	読み方
よみがな	読みがな
よみこ	読み込
よみち	夜道
よみふけ	読み耽
よめ	嫁
よめさん	嫁さん
よもぎ	蓬
よやく	予約
よゆう	余裕
よりあ	寄り合
よりかか	寄りかか
よりかか	寄り掛か
よりき	与力
よりそ	寄り添
よりどころ	拠り所
よりみち	寄り道
よりょく	余力
よる	夜
よろい	鎧
よろく	余録
よろこ	悦
よろこ	歓
よろこ	喜
よろこ	慶
よろこばし	喜ばし
よろし	宜し
よろしく	宜しく
よろず	万
よろん	世論
よわ	弱
よわい	齢
よわき	弱気
よわごし	弱腰
よわね	弱音
よわま	弱ま
よわみ	弱味
よわめ	弱め
よわよわし	弱々し
よん	四
よんどころな	拠ん所な
らーゆ	辣油
らい	雷
らいう	雷雨
らいえん	来演
らいか	来夏
らいかい	来会
らいかん	来館
らいき	来期
らいき	来季
らいきゃく	来客
らいく	ライク
らいげつ	来月
らいこう	来光
らいこう	来校
らいこう	来航
らいごう	来降
らいさん	礼讃
らいさん	礼賛
らいしゃ	来社
らいしゅう	来秋
らいしゅう	来襲
らいしゅう	来週
らいしゅん	来春
らいしょ	来所
らいじょう	来場
らいしん	来信
らいしん	来診
らいせ	来世
らいたく	来宅
らいちょう	来聴
らいちょう	雷鳥
らいてん	来店
らいにち	来日
らいねん	来年
らいねんど	来年度
らいはい	礼拝
らいひん	来賓
らいほう	来訪
らいめい	雷鳴
らいらく	磊落
らいれき	来歴
らがん	裸眼
らく	楽
らくえん	楽園
らくがき	落書
らくがき	落書き
らくがん	落雁
らくご	落後
らくご	落語
らくさ	落差
らくさつ	落札
らくじつ	落日
らくしゅ	落手
らくしょう	楽勝
らくせい	落成
らくせき	落石
らくせん	落選
らくだ	駱駝
らくだい	落第
らくたん	落胆
らくちゃく	落着
らくちょう	落丁
らくてん	楽天
らくのう	酪農
らくば	落馬
らくはく	落魄
らくばん	落磐
らくよう	落葉
らくらい	落雷
らくらく	楽々
らくるい	落涙
らしゅつ	裸出
らしんばん	羅針盤
らせん	螺旋
らち	埓
らち	拉致
らっか	落下
らっかん	楽観
らつわん	辣腕
らでん	螺鈿
られつ	羅列
らん	乱
らん	卵
らん	欄
らん	蘭
らん	覧
らんおう	卵黄
らんがい	欄外
らんかく	乱獲
らんかん	欄干
らんぎょう	乱行
らんきりゅう	乱気流
らんこう	乱交
らんこうげ	乱高下
らんこん	乱婚
らんざつ	乱雑
らんし	乱視
らんし	卵子
らんしゃ	乱射
らんじゅく	爛熟
らんすう	乱数
らんせん	乱戦
らんそう	卵巣
らんちょう	乱丁
らんちょう	乱調
らんとう	乱闘
らんどく	乱読
らんにゅう	乱入
らんぱく	卵白
らんばつ	乱伐
らんぱつ	乱発
らんぴ	乱費
らんぶ	乱舞
らんぼう	乱暴
らんま	欄間
らんまん	爛漫
らんみゃく	乱脈
らんよう	乱用
らんよう	濫用
らんらん	爛々
らんりつ	乱立
り	利
り	理
り	裏
り	里
りいん	吏員
りえき	利益
りか	理科
りかい	理解
りがい	利害
りがく	理学
りがくぶ	理学部
りき	利器
りき	力
りきえん	力演
りきがく	力学
りきさく	力作
りきし	力士
りきせつ	力説
りきせん	力戦
りきとう	力闘
りきゅう	離宮
りきりょう	力量
りく	陸
りくあげ	陸揚げ
りくうん	陸運
りくかいぐん	陸海軍
りくぐん	陸軍
りくじょう	陸上
りくち	陸地
りくつ	理屈
りくとう	陸稲
りくろ	陸路
りけい	理系
りけん	利権
りこ	利己
りこう	履行
りこう	理工
りごう	離合
りこん	離婚
りざや	利鞘
りさん	離散
りし	利子
りじ	理事
りしゅう	履修
りじゅん	利潤
りしょく	離職
りしんろん	理神論
りすうけい	理数系
りせい	理性
りそう	理想
りそく	利息
りそん	離村
りた	利他
りだつ	離脱
りち	理知
りちぎ	律儀
りちぎ	律義
りちゃくりく	離着陸
りちゃっかん	離着艦
りっ	律
りつ	律
りつ	率
りつ	葎
りつあん	立案
りっか	立夏
りっきゃく	立脚
りっきょう	陸橋
りっけん	立憲
りっこうほ	立候補
りっし	立志
りっしゅう	立秋
りっしゅん	立春
りっしょう	立証
りっしょく	立食
りっしん	立身
りつぜん	慄然
りつぞう	立像
りっそく	律速
りったい	立体
りっとう	立冬
りつどう	律動
りっぱ	立派
りっぷく	立腹
りっぽう	立法
りっぽうたい	立方体
りづめ	理詰め
りつろん	立論
りてん	利点
りとう	離島
りとく	利得
りにゅう	離乳
りねん	理念
りのう	離農
りはつ	利発
りはつ	理髪
りはっちゃく	離発着
りばらい	利払い
りふじん	理不尽
りべつ	離別
りべん	利便
りまわり	利回り
りめん	裏面
りゃく	略
りゃくかい	略解
りゃくぎ	略儀
りゃくご	略語
りゃくじ	略字
りゃくしき	略式
りゃくしょう	略称
りゃくず	略図
りゃくそう	略装
りゃくだつ	略奪
りゃくひつ	略筆
りゃくれき	略歴
りゃっかい	略解
りゃっき	略記
りゅう	流
りゅう	竜
りゅう	龍
りゆう	理由
りゅうい	留意
りゅういき	流域
りゅういん	溜飲
りゅうか	硫化
りゅうかい	流会
りゅうがく	留学
りゅうがくせい	留学生
りゅうかん	流感
りゅうがん	竜顔
りゅうき	隆起
りゅうぎ	流儀
りゅうけつ	流血
りゅうげん	流言
りゅうげんひご	流言飛語
りゅうげんひご	流言蜚語
りゅうこう	流行
りゅうさん	硫酸
りゅうざん	流産
りゅうし	粒子
りゅうしつ	流失
りゅうしゅつ	流出
りゅうず	竜頭
りゅうすい	流水
りゅうせい	隆盛
りゅうそく	流速
りゅうたい	流体
りゅうだん	榴弾
りゅうち	留置
りゅうちょう	流暢
りゅうつう	流通
りゅうど	粒度
りゅうどう	流動
りゅうとうだび	竜頭蛇尾
りゅうとうだび	龍頭蛇尾
りゅうにゅう	流入
りゅうにん	留任
りゅうねん	留年
りゅうは	流派
りゅうひょう	流氷
りゅうほ	留保
りゅうよう	流用
りゅうりょう	流量
りょう	漁
りょう	了
りょう	両
りょう	寮
りょう	料
りょう	猟
りょう	良
りょう	諒
りょう	量
りょう	領
りよう	利用
りよう	理容
りょうあし	両足
りょういき	領域
りょういん	両院
りょうえん	良縁
りょうが	凌駕
りょうかい	了解
りょうかい	諒解
りょうかい	領海
りょうがえ	両替
りょうがわ	両側
りょうかん	量感
りょうき	猟奇
りょうきょく	両極
りょうきん	料金
りょうくう	領空
りょうけ	両家
りょうけん	了見
りょうけん	両県
りょうけん	料簡
りょうけん	猟犬
りようけん	利用券
りょうこう	良好
りょうこく	両国
りょうさいけんぼ	良妻賢母
りょうさく	良策
りょうさん	量産
りょうし	漁師
りょうし	両市
りょうし	両氏
りょうし	猟師
りょうし	量子
りょうじ	療治
りょうじ	領事
りょうしき	良識
りょうしつ	良質
りょうじつ	両日
りょうしゃ	両社
りょうしゃ	両者
りようしゃ	利用者
りょうしゅ	領主
りょうしゅう	領収
りょうしゅう	領袖
りょうじゅう	猟銃
りょうしょう	了承
りょうしょう	諒承
りょうしょく	糧食
りょうじょく	凌辱
りょうしん	両親
りょうしん	良心
りょうじん	良人
りょうせい	両性
りょうせい	良性
りょうせん	稜線
りょうぜん	霊山
りょうぞく	良俗
りょうたん	両端
りょうだん	両断
りょうち	領地
りょうて	両手
りょうてい	料亭
りょうてき	量的
りょうど	領土
りょうどう	両道
りょうどう	糧道
りょうとうづかい	両刀使い
りょうとく	両得
りょうない	領内
りょうにん	両人
りょうねん	両年
りょうは	両派
りょうはし	両端
りょうひ	良否
りょうぶん	両分
りょうぶん	領分
りょうぼ	寮母
りょうぼ	陵墓
りょうほう	両方
りょうほう	療法
りょうみ	涼味
りょうめ	両目
りょうめん	両面
りょうゆう	領有
りょうよう	両様
りょうよう	両用
りょうよう	療養
りょうよく	両翼
りょうり	料理
りょうりつ	両立
りょうろん	両論
りょがい	慮外
りょかく	旅客
りょかん	旅館
りょくしょく	緑色
りょくち	緑地
りょくちゃ	緑茶
りょけん	旅券
りょこう	旅行
りょじょう	旅情
りょだん	旅団
りょっか	緑化
りょてい	旅程
りょひ	旅費
りりく	離陸
りりし	凛々し
りりつ	利率
りれき	履歴
りれきしょ	履歴書
りろせいぜん	理路整然
りろん	理論
りん	厘
りん	燐
りん	鈴
りんか	隣家
りんかい	臨海
りんかい	臨界
りんかく	輪郭
りんかん	林間
りんぎ	稟議
りんきおうへん	臨機応変
りんぎょう	林業
りんくう	臨空
りんげつ	臨月
りんけん	臨検
りんげん	綸言
りんこう	輪講
りんごく	隣国
りんさん	林産
りんじ	臨時
りんじゅう	臨終
りんしょう	臨床
りんしょう	輪唱
りんじょう	臨場
りんしょく	吝嗇
りんじん	隣人
りんず	綸子
りんせき	臨席
りんせつ	隣接
りんせんたいせい	臨戦体制
りんてん	輪転
りんと	凛と
りんどう	竜胆
りんどう	林道
りんね	輪廻
りんや	林野
りんり	倫理
りんりつ	林立
るい	塁
るい	累
るい	類
るいえん	類縁
るいけい	累計
るいご	類語
るいじ	類似
るいじ	類字
るいしょ	類書
るいしょう	類焼
るいじょう	累乗
るいしん	塁審
るいしん	累進
るいすい	類推
るいせき	累積
るいせん	涙腺
るいどう	類同
るいべつ	類別
るいるい	累々
るす	留守
るすばん	留守番
るてん	流転
るふ	流布
るり	瑠璃
るろう	流浪
れい	例
れい	礼
れい	零
れい	霊
れいあんしつ	霊安室
れいあんしょ	冷暗所
れいえん	霊園
れいか	冷夏
れいか	零下
れいかい	例会
れいかい	例解
れいがい	例外
れいがい	冷害
れいかん	霊感
れいき	冷気
れいぎ	礼儀
れいきゃく	冷却
れいきゅうしゃ	霊柩車
れいきん	礼金
れいぐう	冷遇
れいけつ	冷血
れいげつ	例月
れいけつかん	冷血漢
れいけん	霊験
れいげん	霊験
れいこう	励行
れいこく	冷酷
れいこん	霊魂
れいさい	零細
れいじ	例示
れいじ	零時
れいしょ	隷書
れいしょう	例証
れいしょう	冷笑
れいじょう	令嬢
れいじょう	令状
れいじょう	礼状
れいじょう	霊場
れいすい	冷水
れいせい	冷静
れいせん	冷戦
れいせん	零戦
れいぜん	霊前
れいぞう	冷蔵
れいぞうこ	冷蔵庫
れいそく	令息
れいだい	例題
れいたん	冷淡
れいちょう	霊長
れいど	零度
れいとう	冷凍
れいにゅう	戻入
れいねつ	冷熱
れいねん	例年
れいばい	冷媒
れいばい	霊媒
れいふう	冷風
れいふく	礼服
れいぶん	例文
れいほう	礼法
れいほう	礼砲
れいぼう	冷房
れいめい	黎明
れいれいし	麗々し
れき	暦
れき	歴
れきし	歴史
れきし	轢死
れきぜん	歴然
れきだい	歴代
れきほう	歴訪
れきれき	歴々
れつ	列
れつあく	劣悪
れっか	劣化
れっか	烈火
れっき	列記
れっきと	歴と
れっきょ	列挙
れっきょう	列強
れっこく	列国
れっしゃ	列車
れっしょう	裂傷
れっしん	烈震
れっせい	劣勢
れっせい	劣性
れっせき	列席
れつでん	列伝
れっとう	列島
れっとう	劣等
れっぱく	烈帛
れん	連
れんあい	恋愛
れんか	廉価
れんが	煉瓦
れんかん	連関
れんき	連記
れんきゅう	連休
れんきんじゅつ	錬金術
れんけい	連係
れんけい	連携
れんけつ	連結
れんげん	連言
れんげんし	連言肢
れんこ	連呼
れんご	連語
れんこう	連行
れんごう	連合
れんこん	蓮根
れんさ	連鎖
れんざ	連座
れんさい	連載
れんさく	連作
れんざん	連山
れんじつ	連日
れんしゃ	連射
れんじゅ	連珠
れんしゅう	練習
れんしょ	連署
れんしょう	連勝
れんせい	連成
れんせい	錬成
れんせつ	連接
れんせん	連戦
れんそう	連想
れんぞく	連続
れんぞくたい	連続体
れんだ	連打
れんたい	連体
れんたい	連帯
れんたい	連隊
れんたいし	連体詞
れんだく	連濁
れんたつ	練達
れんだん	連弾
れんちゅう	連中
れんとう	連騰
れんどう	連動
れんねん	連年
れんぱ	連覇
れんぱ	連破
れんぱい	連敗
れんぱつ	連発
れんびん	憐憫
れんぶんせつ	連文節
れんぽう	連峰
れんぽう	連邦
れんま	錬磨
れんめい	連名
れんめい	連盟
れんめん	連綿
れんや	連夜
れんよう	連用
れんようけい	連用形
れんらく	連絡
れんりつ	連立
ろ	櫓
ろ	炉
ろう	労
ろう	弄
ろう	朗
ろう	老
ろう	聾
ろうあ	聾唖
ろうえい	漏洩
ろうか	廊下
ろうか	老化
ろうかい	老獪
ろうがん	老眼
ろうきゅう	老朽
ろうきょう	老境
ろうきょく	浪曲
ろうく	労苦
ろうけつ	蝋纈
ろうご	老後
ろうごく	牢獄
ろうさい	労災
ろうさい	老妻
ろうさく	労作
ろうし	労使
ろうし	浪士
ろうじゃく	老弱
ろうじゅう	老中
ろうじゅく	老熟
ろうしゅつ	漏出
ろうしょう	労相
ろうじょう	老嬢
ろうじょう	籠城
ろうじん	老人
ろうすい	漏水
ろうすい	老衰
ろうせき	蝋石
ろうぜき	狼藉
ろうそ	労組
ろうそく	蝋燭
ろうたい	老体
ろうちん	労賃
ろうでん	漏電
ろうと	漏斗
ろうとう	郎等
ろうどう	労働
ろうどく	朗読
ろうにゃく	老若
ろうにん	浪人
ろうば	老婆
ろうはい	老廃
ろうばい	狼狽
ろうばしん	老婆心
ろうひ	浪費
ろうふ	老夫
ろうふ	老父
ろうぼ	老母
ろうほう	朗報
ろうぼく	老木
ろうむ	労務
ろうりょく	労力
ろうれい	老齢
ろうれつ	陋劣
ろうれん	老練
ろーまじ	ローマ字
ろかた	路肩
ろぎん	路銀
ろく	六
ろく	録
ろくおん	録音
ろくが	録画
ろくしょう	緑青
ろくぶんぎ	六分儀
ろくぼく	肋木
ろくまく	肋膜
ろくめんたい	六面体
ろくよう	六曜
ろけん	露見
ろこう	露光
ろこつ	露骨
ろじ	路地
ろじ	露地
ろしゅつ	露出
ろじょう	路上
ろしん	炉心
ろせん	路線
ろちょう	顱頂
ろっこつ	肋骨
ろっぽう	六法
ろてい	露呈
ろてん	露天
ろてん	露店
ろてん	露点
ろばん	路盤
ろめん	路面
ろん	論
ろんがい	論外
ろんぎ	論議
ろんきゅう	論及
ろんきゅう	論究
ろんきょ	論拠
ろんご	論語
ろんこう	論考
ろんこう	論攷
ろんこく	論告
ろんし	論旨
ろんしゃ	論者
ろんじゃ	論者
ろんじゅつ	論述
ろんしょう	論証
ろんじん	論陣
ろんせつ	論説
ろんそう	論争
ろんだい	論題
ろんちょう	論調
ろんてき	論敵
ろんてん	論点
ろんなん	論難
ろんばく	論駁
ろんぴょう	論評
ろんぶん	論文
ろんぶんし	論文誌
ろんぽう	論法
ろんり	論理
わ	割
わ	環
わ	沸
わ	湧
わ	涌
わ	輪
わ	和
わいきょく	歪曲
わいしょう	矮小
わいせい	矮星
わいせつ	猥褻
わいだん	猥談
わいろ	賄賂
わえい	和英
わか	解
わか	若
わか	判
わか	沸か
わか	分
わか	分か
わか	和歌
わが	我
わが	我が
わかい	和解
わかがえ	若返
わかくさ	若草
わがくに	わが国
わがくに	我が国
わがし	和菓子
わかちがき	わかち書き
わかて	若手
わかば	若葉
わがはい	我輩
わかまつ	若松
わがまま	我がまま
わがまま	我侭
わがまま	我儘
わかめ	若布
わかもの	若者
わがや	我が家
わがや	我家
わかれ	分かれ
わかれ	別れ
わかわかし	若々し
わかん	和姦
わき	脇
わぎ	和議
わきあいあい	和気藹々
わきあいあい	和気靄々
わきげ	脇毛
わきた	沸き立
わきばら	脇腹
わきまえ	弁え
わきみ	わき見
わきみず	湧き水
わきみち	脇道
わぎゅう	和牛
わぎり	輪切り
わく	枠
わくがい	枠外
わくぐみ	枠組
わくせい	惑星
わくない	枠内
わくらん	惑乱
わけ	分け
わけ	訳
わけあたえ	分け与え
わけい	分け入
わけまえ	分け前
わけめ	分け目
わご	和語
わごう	和合
わこうど	若人
わこんようさい	和魂洋才
わざ	技
わざ	業
わさい	和裁
わさび	山葵
わざわい	禍
わざわい	災い
わし	和紙
わし	鷲
わしき	和式
わしつ	和室
わしゃ	話者
わしょく	和食
わずか	僅か
わずら	患
わずら	煩
わずらわ	煩わ
わずらわし	煩わし
わすれ	忘れ
わすれさ	忘れ去
わせ	早稲
わせ	早生
わせい	和声
わせん	和戦
わた	航
わた	渡
わた	棉
わた	綿
わた	亙
わだい	話題
わたくし	私
わたくしごと	私事
わたくしたち	私達
わたくしりつ	私立
わたし	私
わたし	渡し
わたしたち	私たち
わたしたち	私達
わたしども	私ども
わたしども	私供
わたしぶね	渡し船
わだち	轍
わたり	渡り
わたりどり	渡り鳥
わっか	輪っか
わとじ	和綴じ
わな	罠
わに	鰐
わび	詫び
わびじょう	詫状
わふう	和風
わふく	和服
わぶん	和文
わへい	和平
わほう	話法
わぼく	和睦
わめい	和名
わやく	和訳
わよう	和洋
わら	稿
わら	笑
わら	藁
わらび	蕨
わらべ	童
わり	割
わりあい	割合
わりあて	割り当て
わりあて	割当
わりいん	割印
わりかん	割り勘
わりき	割り切
わりこ	割り込
わりざん	割算
わりだか	割高
わりつけ	割り付け
わりばし	割箸
わりび	割り引
わりびき	割引
わりびきさい	割引債
わりふ	割りふ
わりふ	割り振
わりまし	割増し
わりもど	割り戻
わりもどし	割戻し
わりやす	割安
わる	悪
わるあがき	悪あがき
わるぎ	悪気
わるくち	悪口
わるだくみ	悪巧み
わるぢえ	悪知恵
わるびれ	悪びれ
わるもの	悪者
われ	我
われ	割れ
われめ	割れ目
われら	我ら
われわれ	我々
わん	椀
わん	湾
わんがん	湾岸
わんきょく	湾曲
わんしょう	腕章
わんない	湾内
わんぱく	腕白
わんりょく	腕力
